a'	/ˈa/
abandona	/abandˈona/
abandonai	/abandonˈai/
abandonammo	/abandonˈammo/
abandonando	/abandonˈando/
abandonare	/abandonˈare/
abandonaste	/abandonˈaste/
abandonata	/abandonˈata/
abandonate	/abandonˈate/
abandonati	/abandonˈati/
abandonato	/abandonˈato/
abandonava	/abandonˈava/
abandonino	/abandˈonino/
abastanza	/abastˈantsa/
abate	/abˈate/
abbaglia	/abbˈaʎʎa/
abbagliamento	/abbaʎʎamˈento/
abbaia	/abbˈaja/
abbaiano	/abbˈajano/
abbaiavano	/abbajˈavano/
abbaino	/abbaˈino/
abbandonata	/abbandonˈata/
abbandonati	/abbandonˈati/
abbandonato	/abbandonˈato/
abbassare	/abbassˈare/
abbattuta	/abbattˈuta/
abbattuti	/abbattˈuti/
abbattutissimo	/abbattutˈissimo/
abbattuto	/abbattˈuto/
abbellimenti	/abbellimˈenti/
abbi	/ˈabbi/
abbia	/ˈabbja/
abbiamo	/abbjˈamo/
abbiano	/ˈabbjano/
abbiate	/abbjˈate/
abbisogna	/abbizˈoɲɲa/
abboccamento	/abbokkamˈento/
abbondevolmente	/abbondevolmˈente/
abbraccia	/abbrˈatʃtʃa/
abbracci	/abbrˈatʃtʃi/
abbracciare	/abbratʃtʃˈare/
abbracciati	/abbratʃtʃˈati/
abbracciò	/abbratʃtʃˈɔ/
abitanti	/abitˈanti/
abitare	/abitˈare/
abitazione	/abitatstsjˈone/
abiti	/ˈabiti/
abito	/ˈabito/
abnegazione	/abneɡatstsjˈone/
accaduto	/akkadˈuto/
accampando	/akkampˈando/
accampare	/akkampˈare/
accanto	/akkˈanto/
accasciamento	/akkaʃʃamˈento/
accendere	/atʃtʃˈɛndere/
accennò	/atʃtʃennˈɔ/
accenti	/atʃtʃˈɛnti/
accento	/atʃtʃˈɛnto/
accesa	/atʃtʃˈesa/
accese	/atʃtʃˈese/
accesi	/atʃtʃˈesi/
acceso	/atʃtʃˈeso/
accidente	/atʃtʃidˈɛnte/
accidenti	/atʃtʃidˈɛnti/
accompagnarmi	/akkompaɲɲˈarmi/
accompagnata	/akkompaɲɲˈata/
accompagnate	/akkompaɲɲˈate/
accompagnati	/akkompaɲɲˈati/
accompagnato	/akkompaɲɲˈato/
acconcia	/akkˈontʃa/
acconci	/akkˈontʃi/
acconciamente	/akkontʃamˈente/
acconciare	/akkontʃˈare/
acconcio	/akkˈontʃo/
accorge	/akkˈɔrdʒe/
accorgendo	/akkordʒˈɛndo/
accorta	/akkˈɔrta/
accorti	/akkˈɔrti/
accorto	/akkˈɔrto/
accresce	/akkrˈeʃʃe/
accrescere	/akkrˈeʃʃere/
accrescimento	/akkreʃʃimˈento/
accusa	/akkˈuza/
accusato	/akkuzˈato/
acerba	/atʃˈɛrba/
achille	/akˈille/
aci	/ˈatʃi/
acqua	/ˈakkwa/
acque	/ˈakkwe/
acquistare	/akkwistˈare/
acquistasse	/akkwistˈasse/
acquistata	/akkwistˈata/
acquistato	/akkwistˈato/
acquistò	/akkwistˈɔ/
acuta	/akˈuta/
acuto	/akˈuto/
ad	/ˈad/
adamo	/adˈamo/
addietro	/addjˈɛtro/
addio	/addˈio/
addivenne	/addivˈenne/
addormentare	/addormentˈare/
addormentato	/addormentˈato/
addosso	/addˈɔsso/
adempiere	/adˈempjere/
adesso	/adˈɛsso/
adirato	/adirˈato/
adito	/adˈito/
adone	/adˈone/
adopera	/adˈɔpera/
adoperare	/adoperˈare/
adoperata	/adoperˈata/
adoperato	/adoperˈato/
adoperò	/adoperˈɔ/
adorata	/adorˈata/
adorato	/adorˈato/
adorna	/adˈorna/
adornamento	/adornamˈento/
adorno	/adˈorno/
adosso	/adˈɔsso/
adriano	/adrjˈano/
adulterio	/adultˈɛrjo/
adunati	/adunˈati/
adunque	/adˈuŋkwe/
affabile	/affˈabile/
affabilissimamente	/affabilissimamˈente/
affannare	/affannˈare/
affannato	/affannˈato/
affanni	/affˈanni/
affanno	/affˈanno/
affare	/affˈare/
affari	/affˈari/
affaticato	/affatikˈato/
affatto	/affˈatto/
afferma	/affˈerma/
affermando	/affermˈando/
affermano	/affˈermano/
affermare	/affermˈare/
affermava	/affermˈava/
affermi	/affˈermi/
affermo	/affˈermo/
affermò	/affermˈɔ/
affetti	/affˈɛtti/
affetto	/affˈɛtto/
affettuosa	/affettuˈosa/
affettuosamente	/affettuosamˈente/
affezione	/affetstsjˈone/
affidabilità	/affidabilitˈa/
affine	/affˈine/
afflitta	/afflˈitta/
afflitti	/afflˈitti/
afflitto	/afflˈitto/
afflizione	/afflitstsjˈone/
affogato	/affoɡˈato/
africa	/ˈafrika/
africani	/afrikˈani/
africano	/afrikˈano/
agevole	/adʒˈevole/
agevoli	/adʒˈevoli/
agevolmente	/adʒevolmˈente/
aggia	/ˈadʒdʒa/
aggiunge	/adʒdʒˈundʒe/
aggiungendo	/adʒdʒundʒˈɛndo/
aggiungere	/adʒdʒˈundʒere/
aggiunse	/adʒdʒˈunse/
aggiunsero	/adʒdʒˈunsero/
aggiunta	/adʒdʒˈunta/
aggiunto	/adʒdʒˈunto/
agguagliare	/aɡɡwaʎʎˈare/
agio	/ˈadʒo/
agli	/ˈaʎʎi/
agnolo	/ˈaɲɲolo/
agostino	/aɡostˈino/
agresti	/aɡrˈɛsti/
agricoltori	/aɡrikoltˈori/
aguti	/aɡˈuti/
ah	/ˈa/
ahi	/ˈai/
ahimè	/aimˈɛ/
ai	/ˈai/
aiuta	/ajˈuta/
aiutare	/ajutˈare/
aiutata	/ajutˈata/
aiutato	/ajutˈato/
aiuterà	/ajuterˈa/
aiuti	/ajˈuti/
aiuto	/ajˈuto/
al	/ˈal/
alba	/ˈalba/
albergare	/alberɡˈare/
albergato	/alberɡˈato/
albergo	/albˈɛrɡo/
alberi	/ˈalberi/
alberico	/alberˈiko/
albero	/ˈalbero/
alberto	/albˈɛrto/
alcione	/altʃˈone/
alcmena	/alkmˈɛna/
alcuna	/alkˈuna/
alcune	/alkˈune/
alcuni	/alkˈuni/
alcuno	/alkˈuno/
aldo	/ˈaldo/
alessandria	/alessˈandrja/
alessandro	/alessˈandro/
aletto	/alˈetto/
alfeo	/alfˈɛo/
ali	/ˈali/
alighieri	/aliɡjˈɛri/
alla	/ˈalla/
allato	/allˈato/
alle	/ˈalle/
alleanza	/alleˈantsa/
alleggiamento	/alledʒdʒamˈento/
allegra	/allˈeɡra/
allegrezza	/alleɡrˈetstsa/
allegri	/allˈeɡri/
allegro	/allˈeɡro/
allevati	/allevˈati/
allevato	/allevˈato/
allo	/ˈallo/
allora	/allˈora/
allorchè	/allorkˈɛ/
allori	/allˈɔri/
alloro	/allˈɔro/
almeno	/almˈeno/
alquanta	/alkwˈanta/
alquante	/alkwˈante/
alquanti	/alkwˈanti/
alquanto	/alkwˈanto/
alta	/ˈalta/
altamente	/altamˈente/
altare	/altˈare/
altari	/altˈari/
alte	/ˈalte/
altezza	/altˈetstsa/
alti	/ˈalti/
altissima	/altˈissima/
altissime	/altˈissime/
altissimi	/altˈissimi/
altissimo	/altˈissimo/
alto	/ˈalto/
altra	/ˈaltra/
altramenti	/altramˈenti/
altre	/ˈaltre/
altresì	/altresˈi/
altressì	/altressˈi/
altrettante	/altrettˈante/
altrettanto	/altrettˈanto/
altri	/ˈaltri/
altrimenti	/altrimˈenti/
altro	/ˈaltro/
altronde	/altrˈonde/
altrove	/altrˈove/
altrui	/altrˈui/
alvise	/alvˈize/
alza	/ˈaltsa/
alzata	/altsˈata/
alzato	/altsˈato/
alzò	/altsˈɔ/
ama	/ˈama/
amai	/amˈai/
amando	/amˈando/
amano	/ˈamano/
amante	/amˈante/
amanti	/amˈanti/
amara	/amˈara/
amaramente	/amaramˈente/
amare	/amˈare/
amarezza	/amarˈetstsa/
amaro	/amˈaro/
amasse	/amˈasse/
amassi	/amˈassi/
amata	/amˈata/
amate	/amˈate/
amati	/amˈati/
amato	/amˈato/
amatore	/amatˈore/
amava	/amˈava/
amazzone	/amˈadzdzone/
ambasciata	/ambaʃʃˈata/
ambasciate	/ambaʃʃˈate/
amendue	/amendˈue/
amenduni	/amendˈuni/
amerigo	/amerˈiɡo/
amerò	/amerˈɔ/
ami	/ˈami/
amiamo	/amjˈamo/
amica	/amˈika/
amiche	/amˈike/
amichevolmente	/amikevolmˈente/
amici	/amˈitʃi/
amicizia	/amitʃˈitstsja/
amico	/amˈiko/
amistà	/amistˈa/
ammaestramenti	/ammaestramˈenti/
ammaestrati	/ammaestrˈati/
ammaestrato	/ammaestrˈato/
ammaestrò	/ammaestrˈɔ/
ammazzò	/ammatstsˈɔ/
ammenda	/ammˈɛnda/
ammirazione	/ammiratstsjˈone/
amo	/ˈamo/
amò	/amˈɔ/
amore	/amˈore/
amori	/amˈori/
amorosa	/amorˈosa/
amorosamente	/amorosamˈente/
amorose	/amorˈose/
amorosi	/amorˈosi/
amoroso	/amorˈoso/
ampi	/ˈampi/
ampia	/ˈampja/
ampiamente	/ampjamˈente/
ampie	/ˈampje/
ampio	/ˈampjo/
anche	/ˈaŋke/
anco	/ˈaŋko/
ancora	/aŋkˈora/
andai	/andˈai/
andando	/andˈando/
andare	/andˈare/
andarono	/andˈarono/
andasse	/andˈasse/
andassero	/andˈassero/
andata	/andˈata/
andate	/andˈate/
andati	/andˈati/
andato	/andˈato/
andava	/andˈava/
andavano	/andˈavano/
andiamo	/andjˈamo/
andò	/andˈɔ/
andrà	/andrˈa/
andrebbe	/andrˈɛbbe/
andrò	/andrˈɔ/
andromaca	/andrˈɔmaka/
andromeda	/andrˈɔmeda/
anella	/anˈɛlla/
anello	/anˈɛllo/
anfitrione	/anffitriˈone/
angeli	/ˈandʒeli/
angelo	/ˈandʒelo/
angolo	/ˈaŋɡolo/
angoscia	/aŋɡˈɔʃʃa/
angosciosa	/aŋɡoʃʃˈosa/
angoscioso	/aŋɡoʃʃˈoso/
anima	/ˈanima/
animale	/animˈale/
animali	/animˈali/
anime	/anˈime/
animi	/anˈimi/
animo	/ˈanimo/
animosamente	/animosamˈente/
animoso	/animˈoso/
annali	/annˈali/
anni	/ˈanni/
anno	/ˈanno/
annoverare	/annoverˈare/
ansaldo	/ansˈaldo/
anselmo	/ansˈɛlmo/
antecessori	/antetʃessˈori/
antica	/antˈika/
anticamente	/antikamˈente/
antiche	/antˈike/
antichi	/antˈiki/
antichissima	/antikˈissima/
antichissimi	/antikˈissimi/
antichissimo	/antikˈissimo/
antichità	/antikitˈa/
antico	/antˈiko/
antiopa	/antˈiopa/
antonio	/antˈɔnjo/
antri	/ˈantri/
anzi	/ˈantsi/
aperse	/apˈɛrse/
aperta	/apˈɛrta/
apertamente	/apertamˈente/
aperte	/apˈɛrte/
aperti	/apˈɛrti/
aperto	/apˈɛrto/
api	/ˈapi/
apollo	/apˈɔllo/
apostoli	/apˈɔstoli/
apostolo	/apˈɔstolo/
appaia	/appaia/
appaiono	/appˈajono/
apparato	/apparˈato/
appare	/appˈare/
apparecchiare	/apparekkjˈare/
apparecchiata	/apparekkjˈata/
apparecchiate	/apparekkjˈate/
apparecchiati	/apparekkjˈati/
apparecchiato	/apparekkjˈato/
apparecchiò	/apparekkjˈɔ/
apparenza	/apparˈɛntsa/
apparire	/apparˈire/
apparisce	/apparˈiʃʃe/
apparisse	/apparˈisse/
appariva	/apparˈiva/
appartenenti	/appartenˈɛnti/
appartiene	/appartjˈɛne/
apparve	/appˈarve/
appena	/appˈena/
appetiti	/appetˈiti/
appetito	/appetˈito/
appiccato	/appikkˈato/
apporta	/appˈɔrta/
apprendere	/apprˈɛndere/
appreso	/apprˈeso/
appresso	/apprˈɛsso/
apprestare	/apprestˈare/
appunto	/appˈunto/
apri	/ˈapri/
aprì	/aprˈi/
aprire	/aprˈire/
aquila	/ˈakwila/
arbitrio	/arbˈitrjo/
arca	/ˈarka/
arcade	/ˈarkade/
arcadi	/ˈarkadi/
archi	/ˈarki/
arco	/ˈarko/
arde	/ˈarde/
ardendo	/ardˈɛndo/
ardente	/ardˈɛnte/
ardenti	/ardˈɛnti/
ardentissimo	/ardentˈissimo/
ardere	/ˈardere/
ardesse	/ardˈesse/
ardeva	/ardˈeva/
ardire	/ardˈire/
ardita	/ardˈita/
arditamente	/arditamˈente/
arditi	/ardˈiti/
ardito	/ardˈito/
ardiva	/ardˈiva/
ardo	/ˈardo/
ardore	/ardˈore/
arene	/arˈene/
argivi	/ardʒˈivi/
argomentare	/arɡomentˈare/
argomenti	/arɡomˈenti/
argomento	/arɡomˈento/
argonauti	/arɡonˈauti/
aria	/ˈarja/
arianna	/arjˈanna/
armare	/armˈare/
armata	/armˈata/
armati	/armˈati/
armato	/armˈato/
arme	/ˈarme/
armenti	/armˈenti/
armi	/ˈarmi/
armonia	/armonˈia/
arnese	/arnˈese/
arnesi	/arnˈesi/
arpie	/arpˈie/
arrigo	/arrˈiɡo/
arrivare	/arrivˈare/
arrivata	/arrivˈata/
arrivato	/arrivˈato/
arrivò	/arrivˈɔ/
arsa	/ˈarsa/
arse	/ˈarse/
arsi	/ˈarsi/
arso	/ˈarso/
arte	/ˈarte/
artefice	/artˈefitʃe/
artefici	/artˈefitʃi/
arti	/ˈarti/
articoli	/artˈikoli/
articolo	/artˈikolo/
artificio	/artifˈitʃo/
ascanio	/askˈanjo/
ascendente	/aʃʃendˈɛnte/
ascolta	/askˈolta/
ascoltando	/askoltˈando/
ascoltanti	/askoltˈanti/
ascoltare	/askoltˈare/
ascoltata	/askoltˈata/
ascoltate	/askoltˈate/
ascoltato	/askoltˈato/
ascoltava	/askoltˈava/
ascoltò	/askoltˈɔ/
asia	/ˈazja/
asini	/ˈasini/
asino	/ˈasino/
aspetta	/aspˈɛtta/
aspettando	/aspettˈando/
aspettare	/aspettˈare/
aspettata	/aspettˈata/
aspettato	/aspettˈato/
aspettava	/aspettˈava/
aspetti	/aspˈɛtti/
aspetto	/aspˈɛtto/
aspettò	/aspettˈɔ/
aspra	/ˈaspra/
aspramente	/aspramˈente/
aspre	/ˈaspre/
asprezza	/asprˈetstsa/
aspri	/ˈaspri/
aspro	/ˈaspro/
assai	/assˈai/
assalire	/assalˈire/
assalita	/assalˈita/
assaliti	/assalˈiti/
assalito	/assalˈito/
assalitori	/assalitˈori/
assalti	/assˈalti/
assalto	/assˈalto/
assenza	/assˈɛntsa/
assetto	/assˈɛtto/
assiri	/assˈiri/
assolutamente	/assolutamˈente/
assunto	/assˈunto/
astrea	/astrˈɛa/
astrologhi	/astrˈɔloɡi/
atta	/ˈatta/
atte	/ˈatte/
attempati	/attempˈati/
attempato	/attempˈato/
attendendo	/attendˈɛndo/
attendere	/attˈɛndere/
attendeva	/attendˈeva/
attenta	/attˈɛnta/
attentamente	/attentamˈente/
attento	/attˈɛnto/
attenzione	/attentsjˈone/
attese	/attˈese/
atteso	/attˈeso/
atti	/ˈatti/
atto	/ˈatto/
attorno	/attˈorno/
attratto	/attrˈatto/
attraverso	/attravˈɛrso/
attribuire	/attribuˈire/
attribuiscono	/attribuˈiskono/
attribuita	/attribuˈita/
attribuite	/attribuˈite/
attribuiti	/attribuˈiti/
attribuito	/attribuˈito/
audaci	/audˈatʃi/
auguri	/auɡˈuri/
augurio	/auɡˈurjo/
augusto	/auɡˈusto/
aura	/ˈaura/
aure	/ˈaure/
aurora	/aurˈɔra/
ausonio	/auzˈɔnjo/
austro	/ˈaustro/
autore	/autˈore/
autori	/autˈori/
autorità	/autoritˈa/
autunno	/autˈunno/
avanti	/avˈanti/
avari	/avˈari/
avarizia	/avarˈitstsja/
avaro	/avˈaro/
avea	/avˈea/
avello	/avˈɛllo/
avemo	/avˈemo/
avendo	/avˈɛndo/
aventino	/aventˈino/
avere	/avˈere/
averla	/avˈɛrla/
avesse	/avˈesse/
avessero	/avˈessero/
avessi	/avˈessi/
aveste	/avˈeste/
avesti	/avˈesti/
avete	/avˈete/
aveva	/avˈeva/
avevano	/avˈevano/
avevi	/avˈevi/
avevo	/avˈevo/
avezzi	/avˈetstsi/
avezzo	/avˈetstso/
avo	/ˈavo/
avoli	/avˈɔli/
avrà	/avrˈa/
avrai	/avrˈai/
avranno	/avrˈanno/
avrebbe	/avrˈɛbbe/
avrebbero	/avrˈɛbbero/
avrei	/avrˈɛi/
avremmo	/avrˈemmo/
avremo	/avrˈemo/
avreste	/avrˈeste/
avresti	/avrˈesti/
avrete	/avrˈete/
avria	/avrˈia/
avrò	/avrˈɔ/
avuta	/avˈuta/
avute	/avˈute/
avuti	/avˈuti/
avuto	/avˈuto/
avveduto	/avvedˈuto/
avvegna	/ˈavveɲɲa/
avvelenare	/avvelenˈare/
avvenga	/avvˈɛŋɡa/
avvenimenti	/avvenimˈenti/
avvenimento	/avvenimˈento/
avvenire	/avvenˈire/
avvenisse	/avvenˈisse/
avveniva	/avvenˈiva/
avvenne	/avvˈenne/
avvenuta	/avvenˈuta/
avvenute	/avvenˈute/
avvenuto	/avvenˈuto/
avverrà	/avverrˈa/
avversarii	/avversˈarji/
avversario	/avversˈarjo/
avversi	/avvˈɛrsi/
avversità	/avversitˈa/
avviene	/avviˈɛne/
avviso	/avvˈizo/
azione	/atstsjˈone/
azioni	/atstsjˈoni/
babilonia	/babilˈɔnja/
baciare	/batʃˈare/
baciata	/batʃˈata/
baciava	/batʃˈava/
baci	/ˈbatʃi/
bacio	/batʃˈio/
baciò	/batʃˈɔ/
badessa	/badˈessa/
bagnare	/baɲɲˈare/
bagnata	/baɲɲˈata/
bagnato	/baɲɲˈato/
bagni	/ˈbaɲɲi/
bagno	/ˈbaɲɲo/
bagnò	/baɲɲˈɔ/
balene	/balˈene/
balia	/ˈbalja/
balli	/ˈballi/
ballo	/ˈballo/
banco	/ˈbaŋko/
bandiera	/bandjˈɛra/
bandiere	/bandjˈɛre/
bando	/ˈbando/
barattiere	/barattjˈɛre/
barba	/ˈbarba/
barbari	/ˈbarbari/
barbaro	/ˈbarbaro/
barchetta	/barkˈetta/
barone	/barˈone/
baroni	/barˈoni/
bassa	/ˈbassa/
basse	/ˈbasse/
bassi	/ˈbassi/
basso	/ˈbasso/
basta	/ˈbasta/
bastanti	/bastˈanti/
bastardo	/bastˈardo/
bastare	/bastˈare/
bastasse	/bastˈasse/
bastava	/bastˈava/
basterà	/basterˈa/
bastevole	/bastˈevole/
basti	/ˈbasti/
bastone	/bastˈone/
battaglia	/battˈaʎʎa/
battaglie	/battˈaʎʎe/
batte	/ˈbatte/
battere	/ˈbattere/
battesimo	/battˈezimo/
battitura	/battitˈura/
battiture	/battitˈure/
batto	/ˈbatto/
battuta	/battˈuta/
battuto	/battˈuto/
beata	/beˈata/
beati	/beˈati/
beatitudine	/beatitˈudine/
beato	/beˈato/
beatrice	/beatrˈitʃe/
beffa	/ˈbɛffa/
beffare	/beffˈare/
beffati	/beffˈati/
beffato	/beffˈato/
beffe	/ˈbɛffe/
begli	/ˈbɛʎʎi/
bel	/ˈbɛl/
bella	/ˈbɛlla/
belle	/ˈbɛlle/
bellezza	/bellˈetstsa/
bellezze	/bellˈetstse/
belli	/ˈbɛlli/
bellissima	/bellˈissima/
bellissime	/bellˈissime/
bellissimi	/bellˈissimi/
bellissimo	/bellˈissimo/
bello	/ˈbɛllo/
belo	/ˈbɛlo/
benché	/beŋkˈe/
bene	/ˈbɛne/
benedetta	/benedˈetta/
benedetto	/benedˈetto/
benedizione	/beneditstsjˈone/
benefici	/benefˈitʃi/
beneficio	/benefˈitʃo/
benevento	/ˈbɛnevɛnto/
beni	/ˈbɛni/
benigna	/benˈiɲɲa/
benignamente	/beniɲɲamˈente/
benigni	/benˈiɲɲi/
benignità	/beniɲɲitˈa/
benigno	/benˈiɲɲo/
benissimo	/benˈissimo/
bensì	/bensˈi/
bere	/ˈbere/
berenice	/berenˈitʃe/
bernardo	/bernˈardo/
bestia	/ˈbestja/
bestiale	/bestjˈale/
bestialità	/bestjalitˈa/
bestie	/ˈbestje/
bevanda	/bevˈanda/
bevendo	/bevˈɛndo/
beveraggio	/beverˈadʒdʒo/
bevitori	/bevitˈori/
bevuto	/bevˈuto/
bevve	/ˈbevve/
biade	/bjˈade/
bianca	/bjˈaŋka/
bianche	/bjˈaŋke/
bianchezza	/bjaŋkˈetstsa/
bianchi	/bjˈaŋki/
bianchissima	/bjaŋkˈissima/
bianchissime	/bjaŋkˈissime/
bianco	/bjˈaŋko/
biante	/biˈante/
biasimando	/bjazimˈando/
biasimare	/bjazimˈare/
biasimato	/bjazimˈato/
biasimo	/bjˈazimo/
biblioteca	/bibljotˈɛka/
bicchiere	/bikkjˈɛre/
bicchieri	/bikkjˈɛri/
bionda	/bjˈonda/
biondi	/bjˈondi/
bisanti	/bizˈanti/
bisogna	/bizˈoɲɲa/
bisognano	/bizˈoɲɲano/
bisognasse	/bizoɲɲˈasse/
bisognava	/bizoɲɲˈava/
bisogne	/bizˈoɲɲe/
bisognerà	/bizoɲɲerˈa/
bisognerebbe	/bizoɲɲerˈɛbbe/
bisogni	/bizˈoɲɲi/
bisogno	/bizˈoɲɲo/
bocca	/ˈbokka/
bocche	/ˈbokke/
bologna	/bolˈɔɲɲa/
bolognese	/boloɲɲˈese/
bonaparte	/ˈbɔnaparte/
bontà	/bontˈa/
borea	/ˈbɔrea/
borgo	/ˈborɡo/
boschi	/ˈbɔski/
bosco	/ˈbɔsko/
bovio	/ˈbɔvjo/
braccia	/brˈatʃtʃa/
braccio	/brˈatʃtʃo/
brache	/brˈake/
brava	/brˈava/
bravo	/brˈavo/
breve	/brˈɛve/
brevemente	/brevemˈente/
brevi	/brˈɛvi/
brevissimo	/brevˈissimo/
brevità	/brevitˈa/
brieve	/brjˈɛve/
brievemente	/brjevemˈente/
brievi	/brjˈɛvi/
brigata	/briɡˈata/
brigate	/briɡˈate/
bronzo	/brˈondzo/
brun	/brˈun/
bruno	/brˈuno/
bruti	/brˈuti/
bruto	/brˈuto/
brutta	/brˈutta/
brutto	/brˈutto/
bruttura	/bruttˈura/
bucolica	/bukˈɔlika/
bue	/ˈbue/
bugiardi	/budʒˈardi/
bugiardo	/budʒˈardo/
buio	/ˈbujo/
buoi	/bwˈɔi/
buona	/bwˈɔna/
buone	/bwˈɔne/
buoni	/bwˈɔni/
buono	/bwˈɔno/
bus	/ˈbus/
busto	/ˈbusto/
caccia	/ˈkatʃtʃa/
cacciando	/katʃtʃˈando/
cacciare	/katʃtʃˈare/
cacciata	/katʃtʃˈata/
cacciate	/katʃtʃˈate/
cacciati	/katʃtʃˈati/
cacciato	/katʃtʃˈato/
cacciatore	/katʃtʃatˈore/
cacciatori	/katʃtʃatˈori/
cacciò	/katʃtʃˈɔ/
caco	/ˈkako/
cadde	/ˈkadde/
caddero	/ˈkaddero/
cade	/ˈkade/
cadendo	/kadˈɛndo/
cadere	/kadˈere/
cadesse	/kadˈesse/
cadono	/ˈkadono/
caduca	/kadˈuka/
caduco	/kadˈuko/
caduta	/kadˈuta/
caduti	/kadˈuti/
caduto	/kadˈuto/
caffè	/kaffˈɛ/
cagione	/kadʒˈone/
cagioni	/kadʒˈoni/
cagnolino	/kaɲɲolˈino/
calai	/kalˈai/
calandrino	/kalˈandrino/
calda	/ˈkalda/
calde	/ˈkalde/
caldi	/ˈkaldi/
caldo	/ˈkaldo/
calere	/kalˈere/
calesse	/kalˈɛsse/
calido	/ˈkalido/
caligine	/kalˈidʒine/
calisto	/kalˈisto/
calma	/ˈkalma/
calore	/kalˈore/
cambiato	/kambjˈato/
cambiò	/kambjˈɔ/
camicia	/kamˈitʃa/
camminando	/kamminˈando/
cammino	/kammˈino/
campagna	/kampˈaɲɲa/
campagne	/kampˈaɲɲe/
campa	/ˈkampa/
campare	/kampˈare/
campidoglio	/kampidˈɔʎʎo/
campi	/ˈkampi/
campo	/ˈkampo/
canale	/kanˈale/
candia	/ˈkandja/
candidi	/ˈkandidi/
candido	/ˈkandido/
cane	/ˈkane/
cani	/ˈkani/
can	/ˈkan/
cannelle	/kannˈɛlle/
canta	/ˈkanta/
cantando	/kantˈando/
cantano	/ˈkantano/
cantare	/kantˈare/
cantarono	/kantˈarono/
cantate	/kantˈate/
cantava	/kantˈava/
cantavano	/kantˈavano/
canti	/ˈkanti/
canto	/ˈkanto/
cantò	/kantˈɔ/
canzone	/kantsˈone/
canzonette	/kantsonˈette/
canzoni	/kantsˈoni/
capace	/kapˈatʃe/
capanne	/kapˈanne/
capelli	/kapˈelli/
capello	/kapˈello/
capevole	/kapˈevole/
capi	/ˈkapi/
capire	/kapˈire/
capita	/kapˈita/
capitale	/kapitˈale/
capitani	/kapitˈani/
capitano	/kapitˈano/
capitavano	/kapitˈavano/
capitò	/kapitˈɔ/
capitoli	/kapˈitoli/
capitolo	/kapˈitolo/
capo	/ˈkapo/
cappa	/ˈkappa/
cappello	/kappˈɛllo/
capponi	/kappˈoni/
cappuccio	/kappˈutʃtʃo/
capra	/ˈkapra/
cara	/ˈkara/
carattere	/karˈattere/
caratteri	/karˈatteri/
carboni	/karbˈoni/
carcere	/ˈkartʃere/
cardinale	/kardinˈale/
cardinali	/kardinˈali/
care	/ˈkare/
carezze	/karˈetstse/
carico	/ˈkariko/
cari	/ˈkari/
carissima	/karˈissima/
carissime	/karˈissime/
carissimo	/karˈissimo/
carità	/karitˈa/
carlo	/ˈkarlo/
carnale	/karnˈale/
carne	/ˈkarne/
carni	/ˈkarni/
caro	/ˈkaro/
carretta	/karrˈetta/
carrette	/karrˈette/
carro	/ˈkarro/
carrozza	/karrˈɔtstsa/
carrozzino	/karrotstsˈino/
carta	/ˈkarta/
carte	/ˈkarte/
casa	/ˈkasa/
case	/ˈkase/
casi	/ˈkazi/
caso	/ˈkazo/
cassa	/ˈkassa/
cassetta	/kassˈetta/
casta	/ˈkasta/
castaldo	/kastˈaldo/
castellano	/kastellˈano/
castello	/kastˈɛllo/
castità	/kastitˈa/
casto	/ˈkasto/
catella	/katˈɛlla/
catena	/katˈena/
catene	/katˈene/
caterina	/katerˈina/
catone	/katˈone/
cattaneo	/kattˈaneo/
cattiva	/kattˈiva/
cattive	/kattˈive/
cattivella	/kattivˈɛlla/
cattivi	/kattˈivi/
cattività	/kattivitˈa/
cattivo	/kattˈivo/
cattolica	/kattˈɔlika/
causa	/ˈkauza/
causato	/kauzˈato/
cause	/ˈkauze/
cautamente	/kautamˈente/
cautela	/kautˈɛla/
cavalcando	/kavalkˈando/
cavalcanti	/kavalkˈanti/
cavalcare	/kavalkˈare/
cavalcarono	/kavalkˈarono/
cavalcava	/kavalkˈava/
cavaliere	/kavaljˈɛre/
cavalieri	/kavaljˈɛri/
cavalla	/kavˈalla/
cavalli	/kavˈalli/
cavallino	/kavallˈino/
cavallo	/kavˈallo/
cavare	/kavˈare/
cavata	/kavˈata/
cavati	/kavˈati/
cavato	/kavˈato/
cave	/ˈkave/
caverne	/kavˈɛrne/
cavò	/kavˈɔ/
cecità	/tʃetʃitˈa/
cedere	/ˈtʃɛdere/
cefalo	/ˈtʃɛfalo/
celebrare	/tʃelebrˈare/
celebrato	/tʃelebrˈato/
celebravano	/tʃelebrˈavano/
celeste	/tʃelˈɛste/
celestiale	/tʃelestjˈale/
celestiali	/tʃelestjˈali/
celesti	/tʃelˈɛsti/
celio	/ˈtʃɛljo/
celi	/ˈtʃɛli/
cella	/ˈtʃɛlla/
cenare	/tʃenˈare/
cenarono	/tʃenˈarono/
cenato	/tʃenˈato/
cena	/ˈtʃena/
cenere	/ˈtʃenere/
ceneri	/ˈtʃeneri/
cenno	/ˈtʃenno/
cenò	/tʃenˈɔ/
centauri	/tʃentˈauri/
centauro	/tʃentˈauro/
cento	/ˈtʃɛnto/
centro	/ˈtʃɛntro/
c'era	/ˈtʃera/
cera	/ˈtʃera/
cerbero	/ˈtʃɛrbero/
cercai	/tʃerkˈai/
cercando	/tʃerkˈando/
cercano	/ˈtʃerkano/
cercare	/tʃerkˈare/
cercarono	/tʃerkˈarono/
cercata	/tʃerkˈata/
cercate	/tʃerkˈate/
cercati	/tʃerkˈati/
cercato	/tʃerkˈato/
cerca	/ˈtʃerka/
cercavano	/tʃerkˈavano/
cercava	/tʃerkˈava/
cerchiamo	/tʃerkjˈamo/
cerchio	/ˈtʃerkjo/
cerchi	/ˈtʃerki/
cerco	/ˈtʃerko/
cercò	/tʃerkˈɔ/
certaldo	/tʃertˈaldo/
certamente	/tʃertamˈente/
certa	/ˈtʃɛrta/
certe	/ˈtʃɛrte/
certezza	/tʃertˈetstsa/
certissima	/tʃertˈissima/
certissimo	/tʃertˈissimo/
certi	/ˈtʃɛrti/
certo	/ˈtʃɛrto/
cerva	/ˈtʃɛrva/
cervello	/tʃervˈɛllo/
cervi	/ˈtʃɛrvi/
cervo	/ˈtʃɛrvo/
cesare	/ˈtʃɛzare/
cesari	/ˈtʃɛzari/
cessando	/tʃessˈando/
cessano	/ˈtʃɛssano/
cessare	/tʃessˈare/
cessate	/tʃessˈate/
cessato	/tʃessˈato/
cessino	/ˈtʃɛssino/
cessi	/ˈtʃɛssi/
cessò	/tʃessˈɔ/
cesta	/ˈtʃesta/
cetera	/ˈtʃɛtera/
che	/ˈke/
ché	/ˈke/
chente	/ˈkɛnte/
chenti	/ˈkɛnti/
cheta	/ˈketa/
chetamente	/ketamˈente/
cheto	/ˈketo/
chiamai	/kjamˈai/
chiama	/kjˈama/
chiamando	/kjamˈando/
chiamano	/kjˈamano/
chiamare	/kjamˈare/
chiamarono	/kjamˈarono/
chiamasse	/kjamˈasse/
chiamata	/kjamˈata/
chiamate	/kjamˈate/
chiamati	/kjamˈati/
chiamato	/kjamˈato/
chiamava	/kjamˈava/
chiamavano	/kjamˈavano/
chiamiamo	/kjamjˈamo/
chiami	/kjˈami/
chiamo	/kjˈamo/
chiamò	/kjamˈɔ/
chiara	/kjˈara/
chiaramente	/kjaramˈente/
chiare	/kjˈare/
chiarezza	/kjarˈetstsa/
chiari	/kjˈari/
chiarissima	/kjarˈissima/
chiarissimi	/kjarˈissimi/
chiarissimo	/kjarˈissimo/
chiaro	/kjˈaro/
chiave	/kjˈave/
chiavi	/kjˈavi/
chiede	/kjˈɛde/
chiedere	/kjˈɛdere/
chiedeva	/kjedˈeva/
chiesa	/kjˈɛza/
chiese	/kjˈɛze/
chiesto	/kjˈɛsto/
chi	/ki/
chimera	/kimˈɛra/
chino	/ˈkino/
chinò	/kinˈɔ/
chiodo	/kjˈɔdo/
chioma	/kjˈɔma/
chiude	/kjˈude/
chiudere	/kjˈudere/
chiusa	/kjˈusa/
chiuse	/kjˈuse/
chiusi	/kjˈusi/
chiuso	/kjˈuso/
christiana	/kristjˈana/
ciacco	/ˈtʃakko/
ciance	/ˈtʃantʃe/
cianciatori	/tʃantʃatˈori/
ciascheduno	/tʃaskedˈuno/
ciascuna	/tʃaskˈuna/
ciascuno	/tʃaskˈuno/
ciascun	/tʃaskˈun/
cibi	/ˈtʃibi/
cibo	/ˈtʃibo/
cicerone	/tʃitʃerˈone/
ciciliana	/tʃitʃiljˈana/
ciciliani	/tʃitʃiljˈani/
ciclope	/tʃiklˈɔpe/
ciclopi	/tʃiklˈɔpi/
cicogna	/tʃikˈoɲɲa/
cieca	/ˈtʃɛka/
ciechi	/ˈtʃɛki/
cieco	/ˈtʃɛko/
cieli	/ˈtʃɛli/
cielo	/ˈtʃɛlo/
cigno	/ˈtʃiɲɲo/
cima	/ˈtʃima/
cime	/ˈtʃime/
cinghiale	/tʃiŋɡjˈale/
cino	/ˈtʃino/
cinquanta	/tʃiŋkwˈanta/
cinquecento	/tʃiŋkwetʃˈɛnto/
cinque	/ˈtʃiŋkwe/
cinta	/ˈtʃinta/
cintola	/ˈtʃintola/
cintura	/tʃintˈura/
cioè	/tʃoˈɛ/
ciò	/ˈtʃɔ/
cipolla	/tʃipˈolla/
circa	/ˈtʃirka/
circolo	/ˈtʃirkolo/
circondato	/tʃirkondˈato/
circonda	/tʃirkˈonda/
circonvicini	/tʃirkonfvitʃˈini/
circostanze	/tʃirkostˈantse/
circuito	/tʃirkuˈito/
cisti	/ˈtʃisti/
ci	/ˈtʃi/
cittade	/tʃittˈade/
cittadini	/tʃittadˈini/
cittadino	/tʃittadˈino/
cittadi	/tʃittˈadi/
città	/tʃittˈa/
civile	/tʃivˈile/
civili	/tʃivˈili/
civiltà	/tʃiviltˈa/
claudio	/klˈaudjo/
clelia	/klˈɛlja/
clori	/klˈɔri/
cocenti	/kotʃˈɛnti/
coda	/ˈkoda/
codesto	/kodˈesto/
codice	/ˈkɔditʃe/
cogliendo	/koʎʎˈɛndo/
cogliere	/ˈkɔʎʎere/
cogli	/ˈkɔʎʎi/
cognati	/koɲɲˈati/
cognome	/koɲɲˈome/
coi	/ˈkoi/
colà	/kolˈa/
colei	/kolˈɛi/
col	/ˈkol/
collaborare	/kollaborˈare/
colla	/ˈkolla/
colle	/ˈkolle/
colli	/ˈkɔlli/
collo	/ˈkɔllo/
colmo	/ˈkolmo/
colonna	/kolˈɔnna/
colore	/kolˈore/
colori	/kolˈori/
coloro	/kolˈoro/
colpa	/ˈkolpa/
colpe	/ˈkolpe/
colpevole	/kolpˈevole/
colpevoli	/kolpˈevoli/
colpi	/ˈkolpi/
colpita	/kolpˈita/
colpo	/ˈkolpo/
coltello	/koltˈɛllo/
colto	/ˈkɔlto/
colui	/kolˈui/
comanda	/komˈanda/
comandamenti	/komandamˈenti/
comandamento	/komandamˈento/
comandando	/komandˈando/
comandasse	/komandˈasse/
comandato	/komandˈato/
comandò	/komandˈɔ/
comare	/komˈare/
combattendo	/kombattˈɛndo/
combattenti	/kombattˈɛnti/
combattere	/kombˈattere/
combattuto	/kombattˈuto/
come	/ˈkome/
comici	/ˈkɔmitʃi/
cominciai	/komintʃˈai/
comincia	/komˈintʃa/
cominciando	/komintʃˈando/
cominciare	/komintʃˈare/
cominciarono	/komintʃˈarono/
cominciata	/komintʃˈata/
cominciate	/komintʃˈate/
cominciato	/komintʃˈato/
cominciava	/komintʃˈava/
cominciò	/komintʃˈɔ/
com	/ˈkom/
commendare	/kommendˈare/
commendata	/kommendˈata/
commendato	/kommendˈato/
commendò	/kommendˈɔ/
commenti	/kommˈenti/
commessa	/kommˈessa/
commesse	/kommˈesse/
commesso	/kommˈesso/
commette	/kommˈette/
commettere	/kommˈettere/
commiato	/kommjˈato/
commise	/kommˈize/
commisi	/kommˈizi/
commossa	/kommˈɔssa/
commosse	/kommˈɔsse/
commossi	/kommˈɔssi/
commosso	/kommˈɔsso/
commovente	/kommovˈɛnte/
commune	/kommˈune/
communi	/kommˈuni/
commuovere	/kommwˈɔvere/
compagna	/kompˈaɲɲa/
compagne	/kompˈaɲɲe/
compagnia	/kompaɲɲˈia/
compagni	/kompˈaɲɲi/
compagno	/kompˈaɲɲo/
comparazione	/komparatstsjˈone/
compare	/kompˈare/
comparire	/komparˈire/
comparse	/kompˈarse/
compassione	/kompassjˈone/
comperata	/komperˈata/
comperazione	/komperatstsjˈone/
compiacere	/kompjatʃˈere/
compie	/ˈkompje/
compiere	/ˈkompjere/
compimento	/kompimˈento/
compiuta	/kompjˈuta/
compiutamente	/kompjutamˈente/
compiute	/kompjˈute/
compiuto	/kompjˈuto/
complessione	/komplessjˈone/
complesso	/komplˈɛsso/
completamente	/kompletamˈente/
componendo	/komponˈɛndo/
componimenti	/komponimˈenti/
comporre	/kompˈorre/
comportare	/komportˈare/
compose	/kompˈose/
composizione	/kompozitstsjˈone/
composizioni	/kompozitstsjˈoni/
composta	/kompˈosta/
composte	/kompˈoste/
composti	/kompˈosti/
composto	/kompˈosto/
comprenda	/komprˈɛnda/
comprende	/komprˈɛnde/
comprendendo	/komprendˈɛndo/
comprendere	/komprˈɛndere/
comprendeva	/komprendˈeva/
comprendo	/komprˈɛndo/
compresa	/komprˈesa/
comprese	/komprˈese/
compresi	/komprˈesi/
compreso	/komprˈeso/
comune	/komˈune/
comunemente	/komunemˈente/
comuni	/komˈuni/
comunque	/komˈuŋkwe/
conceda	/kontʃˈɛda/
concedano	/kontʃˈɛdano/
concede	/kontʃˈɛde/
concedendo	/kontʃedˈɛndo/
concederà	/kontʃederˈa/
concedere	/kontʃˈɛdere/
concedesse	/kontʃedˈesse/
concedette	/kontʃedˈɛtte/
concedi	/kontʃˈɛdi/
concedono	/kontʃˈɛdono/
conceduta	/kontʃedˈuta/
concedute	/kontʃedˈute/
conceduto	/kontʃedˈuto/
concento	/kontʃˈɛnto/
concesse	/kontʃˈɛsse/
concesso	/kontʃˈɛsso/
concetto	/kontʃˈɛtto/
conchiudendo	/koŋkjudˈɛndo/
conchiudere	/koŋkjˈudere/
conchiuse	/koŋkjˈuse/
conchiuso	/koŋkjˈuso/
conclusione	/koŋkluzjˈone/
conclusioni	/koŋkluzjˈoni/
concordia	/koŋkˈɔrdja/
concorso	/koŋkˈorso/
concupiscenza	/koŋkupiʃʃˈɛntsa/
concupiscevole	/koŋkupiʃʃˈevole/
condannare	/kondannˈare/
condannata	/kondannˈata/
condannati	/kondannˈati/
condannato	/kondannˈato/
condividi	/kondivˈidi/
condizionalmente	/konditstsjonalmˈente/
condizione	/konditstsjˈone/
condizioni	/konditstsjˈoni/
condotta	/kondˈotta/
condotti	/kondˈotti/
condotto	/kondˈotto/
conduca	/kondˈuka/
conducesse	/kondutʃˈesse/
condurre	/kondˈurre/
condusse	/kondˈusse/
conferma	/konffˈerma/
confermato	/konffermˈato/
confessa	/konffˈɛssa/
confessando	/konffessˈando/
confessare	/konffessˈare/
confessato	/konffessˈato/
confessione	/konffessjˈone/
confesso	/konffˈɛsso/
confessò	/konffessˈɔ/
confetti	/konffˈɛtti/
confinato	/konffinˈato/
confini	/konffˈini/
conforme	/konffˈorme/
conformi	/konffˈormi/
conformità	/konfformitˈa/
conforta	/konffˈɔrta/
confortare	/konffortˈare/
confortati	/konffortˈati/
confortava	/konffortˈava/
conforti	/konffˈɔrti/
conforto	/konffˈɔrto/
confortò	/konffortˈɔ/
confusa	/konffˈuza/
confusione	/konffuzjˈone/
congedo	/kondʒˈɛdo/
congiunge	/kondʒˈundʒe/
congiungere	/kondʒˈundʒere/
congiungimenti	/kondʒundʒimˈenti/
congiungimento	/kondʒundʒimˈento/
congiunse	/kondʒˈunse/
congiunta	/kondʒˈunta/
congiunte	/kondʒˈunte/
congiunti	/kondʒˈunti/
congiunto	/kondʒˈunto/
con	/ˈkon/
conobbe	/konˈobbe/
conobbero	/konˈobbero/
conobbi	/konˈobbi/
conosca	/konˈoska/
conosce	/konˈoʃʃe/
conoscendo	/konoʃʃˈɛndo/
conoscente	/konoʃʃˈɛnte/
conoscenti	/konoʃʃˈɛnti/
conoscenza	/konoʃʃˈɛntsa/
conoscerai	/konoʃʃerˈai/
conoscerà	/konoʃʃerˈa/
conoscere	/konˈoʃʃere/
conoscesse	/konoʃʃˈesse/
conoscessi	/konoʃʃˈessi/
conoscete	/konoʃʃˈete/
conosceva	/konoʃʃˈeva/
conosciamo	/konoʃʃˈamo/
conosciate	/konoʃʃˈate/
conosci	/konˈoʃʃi/
conosciuta	/konoʃʃˈuta/
conosciute	/konoʃʃˈute/
conosciuti	/konoʃʃˈuti/
conosciuto	/konoʃʃˈuto/
conosco	/konˈosko/
conoscono	/konˈoskono/
consacrato	/konsakrˈato/
consapevole	/konsapˈevole/
consapevoli	/konsapˈevoli/
conseguente	/konseɡwˈɛnte/
conseguenza	/konseɡwˈɛntsa/
conseguenze	/konseɡwˈɛntse/
conseguire	/konseɡwˈire/
consente	/konsˈɛnte/
consentì	/konsentˈi/
consentimento	/konsentimˈento/
consentire	/konsentˈire/
consentito	/konsentˈito/
consequente	/konsekwˈɛnte/
conserva	/konservˈa/
considera	/konsˈidera/
considerando	/konsiderˈando/
considerare	/konsiderˈare/
considerata	/konsiderˈata/
considerate	/konsiderˈate/
considerato	/konsiderˈato/
considerava	/konsiderˈava/
considerazione	/konsideratstsjˈone/
consideriamo	/konsiderjˈamo/
consigliare	/konsiʎʎˈare/
consigliato	/konsiʎʎˈato/
consigli	/konsˈiʎʎi/
consiglio	/konsˈiʎʎo/
consiste	/konsˈiste/
consolare	/konsolˈare/
consolata	/konsolˈata/
consolato	/konsolˈato/
consolazione	/konsolatstsjˈone/
consonante	/konsonˈante/
consonanti	/konsonˈanti/
conspetto	/konspˈɛtto/
consueto	/konsuˈɛto/
consuetudine	/konsuetˈudine/
consumato	/konsumˈato/
consumi	/konsˈumi/
contadini	/kontadˈini/
contado	/kontˈado/
contaminare	/kontaminˈare/
contegno	/kontˈɛɲɲo/
conte	/ˈkonte/
contemporanei	/kontemporˈanei/
contenga	/kontˈɛŋɡa/
contengono	/kontˈɛŋɡono/
contenta	/kontˈɛnta/
contentare	/kontentˈare/
contentezza	/kontentˈetstsa/
contenti	/kontˈɛnti/
contento	/kontˈɛnto/
contenuto	/kontenˈuto/
contesa	/kontˈesa/
contessa	/kontˈessa/
contessina	/kontessˈina/
contezza	/kontˈetstsa/
contiene	/kontjˈɛne/
conti	/ˈkonti/
continua	/kontˈinua/
continuamente	/kontinuamˈente/
continuando	/kontinuˈando/
continuare	/kontinuˈare/
continue	/kontˈinue/
continui	/kontˈinui/
continuo	/kontˈinuo/
continuò	/kontinuˈɔ/
conto	/ˈkonto/
contò	/kontˈɔ/
contrada	/kontrˈada/
contraddizione	/kontradditstsjˈone/
contrade	/kontrˈade/
contraria	/kontrˈarja/
contrarie	/kontrˈarje/
contrarietà	/kontrarjetˈa/
contrarii	/kontrˈarji/
contrari	/kontrˈari/
contrario	/kontrˈarjo/
contrastare	/kontrastˈare/
contrasto	/kontrˈasto/
contratto	/kontrˈatto/
contro	/ˈkontro/
convenevole	/konfvenˈevole/
convenevolezza	/konfvenevolˈetstsa/
convenevoli	/konfvenˈevoli/
convenevolmente	/konfvenevolmˈente/
convenga	/konfvˈɛŋɡa/
convengono	/konfvˈɛŋɡono/
convenia	/konfvenˈia/
convenisse	/konfvenˈisse/
conveniva	/konfvenˈiva/
convenne	/konfvˈenne/
convenuto	/konfvenˈuto/
converrà	/konfverrˈa/
converrebbe	/konfverrˈɛbbe/
converria	/konfverrˈia/
conversa	/konfvˈɛrsa/
converse	/konfvˈɛrse/
conversione	/konfversjˈone/
converso	/konfvˈɛrso/
convertì	/konfvertˈi/
convertita	/konfvertˈita/
convertito	/konfvertˈito/
conviene	/konfviˈɛne/
convinzione	/konfvintsjˈone/
conviti	/konfvˈiti/
convito	/konfvˈito/
coperta	/kopˈɛrta/
coperte	/kopˈɛrte/
coperti	/kopˈɛrti/
coperto	/kopˈɛrto/
copia	/ˈkɔpja/
copiosa	/kopjˈosa/
copioso	/kopjˈoso/
coppa	/ˈkoppa/
coprire	/koprˈire/
coraggio	/korˈadʒdʒo/
corde	/ˈkɔrde/
cordoglio	/kordˈɔʎʎo/
coricò	/korikˈɔ/
corna	/ˈkorna/
corni	/ˈkɔrni/
corno	/ˈkɔrno/
cornuta	/kornˈuta/
corollario	/korollˈarjo/
corona	/korˈona/
coronata	/koronˈata/
coronato	/koronˈato/
corone	/korˈone/
coronide	/korˈɔnide/
corpi	/ˈkɔrpi/
corpo	/ˈkɔrpo/
corporale	/korporˈale/
corporali	/korporˈali/
correa	/ˈkɔrrea/
correggere	/korrˈɛdʒdʒere/
corre	/ˈkɔrre/
correndo	/korrˈɛndo/
corrente	/korrˈɛnte/
correnti	/korrˈɛnti/
correre	/ˈkorrere/
correva	/korrˈeva/
corrono	/ˈkorrono/
corrotta	/korrˈotta/
corrotto	/korrˈotto/
corsa	/ˈkɔrsa/
corsari	/korsˈari/
corse	/ˈkɔrse/
corsero	/ˈkorsero/
corsi	/ˈkɔrsi/
corso	/ˈkɔrso/
corta	/ˈkorta/
corteccia	/kortˈetʃtʃa/
corte	/ˈkorte/
cortese	/kortˈeze/
cortesemente	/kortezemˈente/
cortesia	/kortezˈia/
cortesi	/kortˈezi/
cortigiana	/kortidʒˈana/
corti	/ˈkorti/
cortile	/kortˈile/
corto	/ˈkorto/
corvo	/ˈkɔrvo/
cosa	/ˈkɔsa/
coscia	/ˈkɔʃʃa/
coscienza	/koʃʃˈɛntsa/
cose	/ˈkɔse/
cosi	/ˈkɔzi/
così	/kosˈi/
cosmografia	/kozmoɡrafˈia/
cospetto	/kospˈɛtto/
costa	/ˈkɔsta/
costà	/kostˈa/
costante	/kostˈante/
costantemente	/kostantemˈente/
costanza	/kostˈantsa/
costei	/kostˈɛi/
costì	/kostˈi/
costituisce	/kostituˈiʃʃe/
costoro	/kostˈoro/
costretta	/kostrˈetta/
costretti	/kostrˈetti/
costretto	/kostrˈetto/
costrinse	/kostrˈinse/
costruire	/kostruˈire/
costruzione	/kostrutstsjˈone/
costui	/kostˈui/
costumata	/kostumˈata/
costumato	/kostumˈato/
costume	/kostˈume/
costumi	/kostˈumi/
cotale	/kotˈale/
cotali	/kotˈali/
cotante	/kotˈante/
cotanti	/kotˈanti/
cotanto	/kotˈanto/
cotesta	/kotˈesta/
coteste	/kotˈeste/
cotesti	/kotˈesti/
cotesto	/kotˈesto/
crea	/krˈɛa/
creare	/kreˈare/
creata	/kreˈata/
create	/kreˈate/
creati	/kreˈati/
creato	/kreˈato/
creatore	/kreatˈore/
creatura	/kreatˈura/
creature	/kreatˈure/
crebbe	/krˈebbe/
creda	/krˈeda/
credano	/krˈedano/
crede	/krˈede/
credendo	/kredˈɛndo/
crederei	/krederˈɛi/
credere	/krˈedere/
crederò	/krederˈɔ/
credesse	/kredˈesse/
credessi	/kredˈessi/
credete	/kredˈete/
credette	/kredˈɛtte/
credettero	/kredˈɛttero/
credetti	/kredˈɛtti/
credeva	/kredˈeva/
credevano	/kredˈevano/
credevi	/kredˈevi/
crediamo	/kredjˈamo/
crediate	/kredjˈate/
credibile	/kredˈibile/
credi	/krˈedi/
credo	/krˈɛdo/
credono	/krˈedono/
credute	/kredˈute/
creduto	/kredˈuto/
cresce	/krˈeʃʃe/
crescendo	/kreʃʃˈɛndo/
crescente	/kreʃʃˈɛnte/
crescere	/krˈeʃʃere/
crescete	/kreʃʃˈete/
cresciuta	/kreʃʃˈuta/
cresciuti	/kreʃʃˈuti/
cresciuto	/kreʃʃˈuto/
crescono	/krˈeskono/
creta	/krˈeta/
cretese	/kretˈese/
cretesi	/kretˈesi/
crini	/krˈini/
cristallo	/kristˈallo/
cristiana	/kristjˈana/
cristianesimo	/kristjanˈezimo/
cristiani	/kristjˈani/
cristiano	/kristjˈano/
cristo	/krˈisto/
critica	/krˈitika/
crivello	/krivˈɛllo/
croce	/krˈotʃe/
cromi	/krˈɔmi/
crucciati	/krutʃtʃˈati/
crucciato	/krutʃtʃˈato/
cruccio	/krˈutʃtʃo/
cruda	/krˈuda/
crudele	/krudˈɛle/
crudeli	/krudˈɛli/
crudelissimo	/krudelˈissimo/
crudelmente	/krudelmˈente/
crudeltà	/krudeltˈa/
crudo	/krˈudo/
cucina	/kutʃˈina/
cui	/ˈkui/
culla	/ˈkulla/
culto	/ˈkulto/
culturale	/kulturˈale/
cuoco	/kwˈɔko/
cuoio	/kwˈɔjo/
cuore	/kwˈɔre/
cuori	/kwˈɔri/
cupido	/ˈkupido/
cura	/ˈkura/
curano	/ˈkurano/
curare	/kurˈare/
curato	/kurˈato/
curava	/kurˈava/
cure	/ˈkure/
curiosità	/kurjositˈa/
curo	/ˈkuro/
curò	/kurˈɔ/
curva	/ˈkurva/
custode	/kustˈɔde/
custodia	/kustˈɔdja/
d'achille	/dakˈille/
da	/ˈda/
dà	/ˈda/
dagli	/ˈdaʎʎi/
dai	/ˈdai/
dal	/ˈdal/
dalla	/ˈdalla/
dalle	/ˈdalle/
dalli	/ˈdalli/
dallo	/ˈdallo/
damigella	/damidʒˈɛlla/
damigelle	/damidʒˈɛlle/
d'amore	/damˈore/
danari	/danˈari/
dando	/ˈdando/
dannata	/dannˈata/
dannati	/dannˈati/
danni	/ˈdanni/
danno	/ˈdanno/
dannosa	/dannˈosa/
dannosi	/dannˈosi/
dannoso	/dannˈoso/
dante	/ˈdante/
danza	/ˈdantsa/
dardano	/dardˈano/
dardi	/ˈdardi/
dardo	/ˈdardo/
darebbe	/darˈɛbbe/
dare	/ˈdare/
dargli	/ˈdarʎi/
dario	/ˈdarjo/
darti	/ˈdarti/
dassi	/ˈdassi/
data	/ˈdata/
date	/ˈdate/
dati	/ˈdati/
dato	/ˈdato/
dattorno	/dattˈorno/
dava	/ˈdava/
davano	/ˈdavano/
davanti	/davˈanti/
davvero	/davvˈero/
dea	/ˈdɛa/
debba	/ˈdɛbba/
debbano	/ˈdɛbbano/
debbia	/ˈdɛbbja/
debbi	/ˈdɛbbi/
debbo	/ˈdɛbbo/
debbono	/ˈdɛbbono/
debile	/ˈdɛbile/
debita	/ˈdebita/
debitamente	/debitamˈente/
debite	/ˈdebite/
debito	/ˈdebito/
debole	/ˈdebole/
debolezza	/debolˈetstsa/
deboli	/ˈdeboli/
decima	/ˈdɛtʃima/
decimo	/ˈdɛtʃimo/
decisa	/detʃˈiza/
declinare	/deklinˈare/
decreto	/dekrˈeto/
dedalo	/ˈdɛdalo/
de	/ˈde/
de'	/ˈde/
dedicata	/dedikˈata/
dedicato	/dedikˈato/
dee	/ˈdɛe/
deggia	/ˈdɛdʒdʒa/
degli	/ˈdeʎʎi/
degna	/ˈdeɲɲa/
degnamente	/deɲɲamˈente/
degne	/ˈdeɲɲe/
degni	/ˈdeɲɲi/
degno	/ˈdeɲɲo/
deh	/ˈdɛ/
dei	/ˈdɛi/
deità	/deitˈa/
del	/ˈdel/
d'elettrione	/delettrjˈone/
delfino	/delfˈino/
delfo	/ˈdɛlfo/
deliberato	/deliberˈato/
della	/ˈdella/
delle	/ˈdelle/
dello	/ˈdello/
demoni	/ˈdɛmoni/
denari	/denˈari/
dente	/ˈdɛnte/
denti	/ˈdɛnti/
dentro	/ˈdentro/
deono	/ˈdɛono/
deriva	/derˈiva/
descritta	/deskrˈitta/
descritto	/deskrˈitto/
descrive	/deskrˈive/
descrivendo	/deskrivˈɛndo/
descrivere	/deskrˈivere/
desiderando	/desiderˈando/
desiderano	/desˈiderano/
desiderare	/desiderˈare/
desiderato	/desiderˈato/
desiderava	/desiderˈava/
desideri	/desidˈɛri/
desiderio	/desidˈɛrjo/
desideroso	/desiderˈoso/
designare	/desiɲɲˈare/
desinare	/dezinˈare/
desinato	/dezinˈato/
desio	/dezˈio/
desse	/ˈdesse/
dessero	/ˈdessero/
destare	/destˈare/
destati	/destˈati/
desti	/ˈdesti/
destino	/destˈino/
desto	/ˈdesto/
destò	/destˈɔ/
destra	/ˈdɛstra/
destre	/ˈdɛstre/
destriere	/destrjˈɛre/
destro	/ˈdɛstro/
determinata	/determinˈata/
determinato	/determinˈato/
detta	/ˈdetta/
dette	/ˈdette/
detti	/ˈdetti/
detto	/ˈdetto/
deve	/ˈdɛve/
deversi	/devˈɛrsi/
devo	/ˈdɛvo/
dia	/ˈdia/
dialettica	/dialˈɛttika/
dialogo	/diˈaloɡo/
diana	/djˈana/
diano	/ˈdiano/
dianzi	/djˈantsi/
diate	/djˈate/
diavolo	/djˈavolo/
dica	/ˈdika/
dicano	/ˈdikano/
dice	/ˈditʃe/
dicembre	/ditʃˈɛmbre/
dicemmo	/ditʃˈemmo/
dicendo	/ditʃˈɛndo/
dicesse	/ditʃˈesse/
dicessero	/ditʃˈessero/
dicessi	/ditʃˈessi/
diceste	/ditʃˈeste/
dicesti	/ditʃˈesti/
diceva	/ditʃˈeva/
dicevano	/ditʃˈevano/
dicevi	/ditʃˈevi/
dichiarare	/dikjarˈare/
dichiarata	/dikjarˈata/
dichiarate	/dikjarˈate/
dichiarato	/dikjarˈato/
dichiarazione	/dikjaratstsjˈone/
dichi	/ˈdiki/
diciamo	/ditʃˈamo/
diciate	/ditʃˈate/
dici	/ˈditʃi/
dico	/ˈdiko/
dicono	/ˈdikono/
di	/ˈdi/
dì	/ˈdi/
diece	/djˈɛtʃe/
dieci	/djˈɛtʃi/
diede	/djˈɛde/
diedero	/djˈɛdero/
die	/ˈdie/
dietro	/djˈɛtro/
difendere	/difˈɛndere/
difenditore	/difenditˈore/
difesa	/difˈesa/
difese	/difˈese/
difeso	/difˈeso/
difetti	/difˈɛtti/
difetto	/difˈɛtto/
differente	/differˈɛnte/
differenti	/differˈɛnti/
differenza	/differˈɛntsa/
differenze	/differˈɛntse/
difficile	/diffˈitʃile/
difficoltà	/diffikoltˈa/
difficultà	/diffikultˈa/
diffusamente	/diffuzamˈente/
diffusione	/diffuzjˈone/
digiunare	/didʒunˈare/
digiuni	/didʒˈuni/
digiuno	/didʒˈuno/
dignità	/diɲɲitˈa/
diletta	/dilˈɛtta/
dilettano	/dilˈɛttano/
dilettare	/dilettˈare/
dilettato	/dilettˈato/
dilettava	/dilettˈava/
dilettevole	/dilettˈevole/
dilettevoli	/dilettˈevoli/
diletti	/dilˈɛtti/
diletto	/dilˈɛtto/
diliberato	/diliberˈato/
diligente	/dilidʒˈɛnte/
diligentemente	/dilidʒentemˈente/
dilungatosi	/diluŋɡatˈozi/
diluvio	/dilˈuvjo/
dimenticando	/dimentikˈando/
dimenticare	/dimentikˈare/
dimenticata	/dimentikˈata/
dimenticato	/dimentikˈato/
dimentichi	/dimˈentiki/
dimestichezza	/dimestikˈetstsa/
dimora	/dimˈɔra/
dimorando	/dimorˈando/
dimorano	/dimˈɔrano/
dimorante	/dimorˈante/
dimorare	/dimorˈare/
dimorarono	/dimorˈarono/
dimorasse	/dimorˈasse/
dimorata	/dimorˈata/
dimorate	/dimorˈate/
dimorati	/dimorˈati/
dimorato	/dimorˈato/
dimorava	/dimorˈava/
dimoravano	/dimorˈavano/
dimorerò	/dimorerˈɔ/
dimoriamo	/dimorjˈamo/
dimori	/dimˈɔri/
dimoro	/dimˈɔro/
dimorò	/dimorˈɔ/
dimostra	/dimˈostra/
dimostrando	/dimostrˈando/
dimostrano	/dimˈostrano/
dimostrare	/dimostrˈare/
dimostrasse	/dimostrˈasse/
dimostrata	/dimostrˈata/
dimostrato	/dimostrˈato/
dimostrava	/dimostrˈava/
dimostrazione	/dimostratstsjˈone/
dimostrerà	/dimostrerˈa/
dimostri	/dimˈostri/
dimostrò	/dimostrˈɔ/
dinanzi	/dinˈantsi/
dintorno	/dintˈorno/
dio	/ˈdio/
dionigi	/djonˈidʒi/
dionisio	/djonˈizjo/
dipignere	/dipˈiɲɲere/
dipinta	/dipˈinta/
dipinto	/dipˈinto/
dipintore	/dipintˈore/
dipinture	/dipintˈure/
diporto	/dipˈɔrto/
dirà	/dirˈa/
dirai	/dirˈai/
diranno	/dirˈanno/
dirce	/ˈdirtʃe/
direbbe	/dirˈɛbbe/
dire	/ˈdire/
direi	/dirˈɛi/
diremo	/dirˈemo/
diretta	/dirˈɛtta/
dirimpetto	/dirimpˈɛtto/
diritta	/dirˈitta/
dirittamente	/dirittamˈente/
diritti	/dirˈitti/
diritto	/dirˈitto/
dirizzare	/diritstsˈare/
dirizzata	/diritstsˈata/
dirizzò	/diritstsˈɔ/
dirò	/dirˈɔ/
disagio	/dizˈadʒo/
disarmato	/dizarmˈato/
disavventura	/dizavventˈura/
discende	/diʃʃˈende/
discendendo	/diʃʃendˈɛndo/
discendenti	/diʃʃendˈɛnti/
discendenza	/diʃʃendˈɛntsa/
discendere	/diʃʃˈendere/
discepoli	/diʃʃˈepoli/
discepolo	/diʃʃˈepolo/
discesa	/diʃʃˈesa/
discese	/diʃʃˈese/
discesi	/diʃʃˈesi/
disceso	/diʃʃˈeso/
disciplina	/diʃʃiplˈina/
discorda	/diskˈɔrda/
discordano	/diskˈɔrdano/
discordanti	/diskordˈanti/
discordia	/diskˈɔrdja/
discordi	/diskˈɔrdi/
discorrendo	/diskorrˈɛndo/
discorrere	/diskˈorrere/
discorsi	/diskˈorsi/
discorso	/diskˈorso/
discreta	/diskrˈɛta/
discretamente	/diskretamˈente/
discreti	/diskrˈɛti/
discreto	/diskrˈɛto/
discrezione	/diskretstsjˈone/
discussione	/diskussjˈone/
disegna	/disˈeɲɲa/
disegnare	/diseɲɲˈare/
disegno	/disˈeɲɲo/
diserto	/dizˈɛrto/
disiato	/diziˈato/
disii	/dizˈii/
disio	/dizˈio/
disonesta	/dizonˈɛsta/
disonesti	/dizonˈɛsti/
disonesto	/dizonˈɛsto/
disordinato	/dizordinˈato/
disparte	/dispˈarte/
disperata	/disperˈata/
disperato	/disperˈato/
dispersi	/dispˈɛrsi/
dispetto	/dispˈɛtto/
dispiacere	/dispjatʃˈere/
dispone	/dispˈone/
disponibili	/disponˈibili/
disporre	/dispˈorre/
dispose	/dispˈose/
disposta	/dispˈosta/
disposte	/dispˈoste/
disposti	/dispˈosti/
disposto	/dispˈosto/
disprezzo	/disprˈɛtstso/
disputando	/disputˈando/
disputare	/disputˈare/
dispute	/ˈdispute/
disse	/ˈdisse/
dissero	/ˈdissero/
dissi	/ˈdissi/
distanza	/distˈantsa/
distendere	/distˈɛndere/
distesa	/distˈesa/
distese	/distˈese/
disteso	/distˈeso/
distribuito	/distribuˈito/
distruzione	/distrutstsjˈone/
disusata	/dizuzˈata/
dita	/ˈdita/
dite	/ˈdite/
dito	/ˈdito/
divenga	/divˈɛŋɡa/
divenire	/divenˈire/
divenisse	/divenˈisse/
diventa	/divˈɛnta/
diventano	/divˈɛntano/
diventato	/diventˈato/
diventiamo	/diventjˈamo/
diventò	/diventˈɔ/
divenuta	/divenˈuta/
divenute	/divenˈute/
divenuti	/divenˈuti/
divenuto	/divenˈuto/
diversa	/divˈɛrsa/
diversamente	/diversamˈente/
diverse	/divˈɛrse/
diversi	/divˈɛrsi/
diversità	/diversitˈa/
diverso	/divˈɛrso/
dividere	/divˈidere/
diviene	/diviˈɛne/
divina	/divˈina/
divine	/divˈine/
divini	/divˈini/
divinità	/divinitˈa/
divino	/divˈino/
divisa	/divˈiza/
divise	/divˈize/
divisi	/divˈizi/
divisione	/divizjˈone/
diviso	/divˈizo/
divorato	/divorˈato/
divota	/divˈɔta/
divotamente	/divotamˈente/
divoti	/divˈɔti/
divoto	/divˈɔto/
dobbiamo	/dobbjˈamo/
documenti	/dokumˈenti/
dodici	/ˈdoditʃi/
do	/ˈdo/
dogana	/doɡˈana/
doglia	/ˈdɔʎʎa/
doglie	/ˈdɔʎʎe/
doglio	/ˈdɔʎʎo/
dogma	/ˈdɔɡma/
doi	/ˈdoi/
dolce	/ˈdoltʃe/
dolcemente	/doltʃemˈente/
dolcezza	/doltʃˈetstsa/
dolcezze	/doltʃˈetstse/
dolci	/ˈdoltʃi/
dolcissima	/doltʃˈissima/
dolcissime	/doltʃˈissime/
dolcissimi	/doltʃˈissimi/
dolcissimo	/doltʃˈissimo/
dolea	/dolˈea/
dolente	/dolˈɛnte/
dolenti	/dolˈɛnti/
dolere	/dolˈere/
doleva	/dolˈeva/
dolga	/ˈdɔlɡa/
dolgo	/ˈdɔlɡo/
dolore	/dolˈore/
dolori	/dolˈori/
dolorosa	/dolorˈosa/
dolorosamente	/dolorosamˈente/
dolorose	/dolorˈose/
dolorosi	/dolorˈosi/
doloroso	/dolorˈoso/
doluta	/dolˈuta/
doluto	/dolˈuto/
domanda	/domˈanda/
domandando	/domandˈando/
domandano	/domˈandano/
domandare	/domandˈare/
domandarono	/domandˈarono/
domandata	/domandˈata/
domandate	/domandˈate/
domandato	/domandˈato/
domandava	/domandˈava/
domande	/domˈande/
domanderò	/domanderˈɔ/
domandi	/domˈandi/
domando	/domˈando/
domandò	/domandˈɔ/
domane	/domˈane/
domani	/domˈani/
domattina	/domattˈina/
domeneddio	/domeneddˈio/
domenica	/domˈɛnika/
domestica	/domˈɛstika/
domestiche	/domˈɛstike/
domestici	/domˈɛstitʃi/
domestico	/domˈɛstiko/
domine	/ˈdɔmine/
dominio	/domˈinjo/
dona	/ˈdona/
donai	/donˈai/
donare	/donˈare/
donasse	/donˈasse/
donata	/donˈata/
donate	/donˈate/
donati	/donˈati/
donato	/donˈato/
donatore	/donatˈore/
donazione	/donatstsjˈone/
donde	/ˈdonde/
don	/ˈdɔn/
donerò	/donerˈɔ/
doni	/ˈdoni/
donna	/ˈdɔnna/
donne	/ˈdɔnne/
donno	/ˈdɔnno/
dono	/ˈdono/
donò	/donˈɔ/
donzella	/dondzˈɛlla/
donzelle	/dondzˈɛlle/
dopo	/ˈdopo/
doppia	/ˈdoppja/
doppio	/ˈdoppjo/
doppo	/ˈdoppo/
dori	/ˈdɔri/
dorme	/ˈdɔrme/
dormendo	/dormˈɛndo/
dormire	/dormˈire/
dormito	/dormˈito/
dormiva	/dormˈiva/
dormono	/ˈdɔrmono/
dosso	/ˈdɔsso/
dotata	/dotˈata/
dotato	/dotˈato/
dote	/ˈdɔte/
dotti	/ˈdɔtti/
dottissimi	/dottˈissimi/
dottissimo	/dottˈissimo/
dotto	/ˈdɔtto/
dottore	/dottˈore/
dottori	/dottˈori/
dottrina	/dottrˈina/
dottrine	/dottrˈine/
dovea	/dovˈea/
dove	/ˈdove/
dovendo	/dovˈɛndo/
dovere	/dovˈere/
doveri	/dovˈeri/
dovermi	/dovˈɛrmi/
dovesse	/dovˈesse/
dovessero	/dovˈessero/
dovessi	/dovˈessi/
dovete	/dovˈete/
dovette	/dovˈɛtte/
doveva	/dovˈeva/
dovevano	/dovˈevano/
dovevi	/dovˈevi/
dovrà	/dovrˈa/
dovrebbe	/dovrˈɛbbe/
dovrei	/dovrˈɛi/
dovreste	/dovrˈeste/
dovresti	/dovrˈesti/
dovria	/dovrˈia/
dovunque	/dovˈuŋkwe/
dovuta	/dovˈuta/
dovuto	/dovˈuto/
drappi	/drˈappi/
drappo	/drˈappo/
dritta	/drˈitta/
dritti	/drˈitti/
dritto	/drˈitto/
drizzò	/dritstsˈɔ/
dubbi	/ˈdubbi/
dubbio	/ˈdubbjo/
dubbiosa	/dubbjˈosa/
dubbiosi	/dubbjˈosi/
dubbioso	/dubbjˈoso/
dubita	/ˈdubita/
dubitando	/dubitˈando/
dubitare	/dubitˈare/
dubitate	/dubitˈate/
dubitava	/dubitˈava/
dubiti	/ˈdubiti/
dubito	/ˈdubito/
dubitò	/dubitˈɔ/
duca	/ˈduka/
due	/ˈdue/
dugento	/dudʒˈɛnto/
dum	/ˈdum/
dunque	/ˈduŋkwe/
duodecimo	/duodˈɛtʃimo/
duo	/ˈduo/
duole	/dwˈɔle/
duoli	/dwˈɔli/
duolo	/dwˈɔlo/
dura	/ˈdura/
duramente	/duramˈente/
durano	/ˈdurano/
durante	/durˈante/
durare	/durˈare/
durasse	/durˈasse/
durata	/durˈata/
durato	/durˈato/
durava	/durˈava/
dure	/ˈdure/
durerà	/durerˈa/
durevole	/durˈevole/
durezza	/durˈetstsa/
duri	/ˈduri/
duro	/ˈduro/
durò	/durˈɔ/
eaco	/ˈeako/
ea	/ˈea/
ebbe	/ˈɛbbe/
ebbene	/ebbˈɛne/
ebbero	/ˈɛbbero/
ebbi	/ˈɛbbi/
ebbri	/ˈɛbbri/
ebbro	/ˈɛbbro/
eccellente	/etʃtʃellˈɛnte/
eccellenti	/etʃtʃellˈɛnti/
eccellenza	/etʃtʃellˈɛntsa/
eccelse	/etʃtʃˈɛlse/
eccelso	/etʃtʃˈɛlso/
eccetto	/etʃtʃˈɛtto/
ecco	/ˈɛkko/
ed	/ˈed/
edificare	/edifikˈare/
edificarono	/edifikˈarono/
edificata	/edifikˈata/
edificato	/edifikˈato/
edifici	/edifˈitʃi/
edificò	/edifikˈɔ/
editoria	/editorˈia/
edizione	/editstsjˈone/
e'	/ˈe/
effettuosamente	/effettuosamˈente/
efficacia	/effikˈatʃa/
effigie	/effˈidʒe/
egisto	/edʒˈisto/
egitto	/edʒˈitto/
egli	/ˈeʎʎi/
eguale	/eɡwˈale/
eguali	/eɡwˈali/
eh	/ˈɛ/
ei	/ˈɛi/
el	/ˈel/
eleganza	/eleɡˈantsa/
eleggere	/elˈɛdʒdʒere/
elementi	/elemˈenti/
elemento	/elemˈento/
elena	/ˈɛlena/
eletta	/elˈɛtta/
eletto	/elˈɛtto/
elettra	/elˈɛttra/
elettronica	/elettrˈɔnika/
elettronico	/elettrˈɔniko/
elezione	/eletstsjˈone/
ella	/ˈella/
elle	/ˈɛlle/
elli	/ˈelli/
eloquenza	/elokwˈɛntsa/
emilia	/emˈilja/
eminente	/eminˈɛnte/
empie	/ˈɛmpie/
empiono	/ˈɛmpjono/
empito	/empˈito/
en	/ˈen/
enea	/enˈɛa/
ennio	/ˈɛnnjo/
entra	/ˈentra/
entrambi	/entrˈambi/
entrando	/entrˈando/
entrano	/ˈentrano/
entrare	/entrˈare/
entrarono	/entrˈarono/
entrasse	/entrˈasse/
entrata	/entrˈata/
entrate	/entrˈate/
entrati	/entrˈati/
entrato	/entrˈato/
entrava	/entrˈava/
entri	/ˈentri/
entro	/ˈentro/
entrò	/entrˈɔ/
eolo	/ˈɛolo/
era	/ˈɛra/
erano	/ˈɛrano/
eravate	/eravˈate/
erba	/ˈɛrba/
erbe	/ˈɛrbe/
ercolano	/erkolˈano/
ercole	/ˈɛrkole/
erede	/erˈɛde/
eredità	/ereditˈa/
erice	/ˈɛritʃe/
eri	/ˈɛri/
eritreo	/eritrˈɛo/
ero	/ˈɛro/
eroi	/erˈɔi/
errando	/errˈando/
errare	/errˈare/
errore	/errˈore/
errori	/errˈori/
esca	/ˈɛska/
esce	/ˈɛʃʃe/
esclamò	/esklamˈɔ/
escono	/ˈɛskono/
es	/ˈɛs/
esemplare	/ezemplˈare/
esilio	/ezˈiljo/
esistenza	/ezistˈɛntsa/
esitanze	/ezitˈantse/
espansione	/espansjˈone/
esperienza	/esperjˈɛntsa/
esperienzia	/esperjˈɛntsja/
esporre	/espˈorre/
esposta	/espˈosta/
esposto	/espˈosto/
espressione	/espressjˈone/
esprimere	/esprˈimere/
essa	/ˈessa/
esse	/ˈɛsse/
essendo	/essˈɛndo/
essere	/ˈɛssere/
essi	/ˈessi/
essilio	/essˈiljo/
esso	/ˈesso/
est	/ˈɛst/
esteriori	/esterjˈori/
estimando	/estimˈando/
estimava	/estimˈava/
estimo	/estˈimo/
estimò	/estimˈɔ/
estinto	/estˈinto/
estravaganti	/estravaɡˈanti/
estrema	/estrˈɛma/
estremi	/estrˈɛmi/
estremo	/estrˈɛmo/
et	/ˈet/
eterna	/etˈɛrna/
eternità	/eternitˈa/
eterno	/etˈɛrno/
etica	/ˈɛtika/
etico	/ˈɛtiko/
etterni	/ettˈɛrni/
etterno	/ettˈɛrno/
euro	/ˈɛuro/
europa	/eurˈɔpa/
eusebio	/euzˈɛbjo/
evandro	/evˈandro/
evidente	/evidˈɛnte/
evidenza	/evidˈɛntsa/
evo	/ˈɛvo/
ex	/ˈɛks/
faccende	/fatʃtʃˈɛnde/
faccendo	/fatʃtʃˈɛndo/
faccendosi	/fatʃtʃendˈosi/
faccia	/ˈfatʃtʃa/
facciamo	/fatʃtʃˈamo/
facciano	/ˈfatʃtʃano/
facciate	/fatʃtʃˈate/
facci	/ˈfatʃtʃi/
faccio	/ˈfatʃtʃo/
face	/ˈfatʃe/
facendo	/fatʃˈɛndo/
facesse	/fatʃˈesse/
facessero	/fatʃˈessero/
facessi	/fatʃˈessi/
faceste	/fatʃˈeste/
facesti	/fatʃˈesti/
faceva	/fatʃˈeva/
facevano	/fatʃˈevano/
facile	/ˈfatʃile/
facili	/ˈfatʃili/
facilmente	/fatʃilmˈente/
facondia	/fakˈondja/
facultà	/fakultˈa/
fa	/ˈfa/
fagiana	/fadʒˈana/
fai	/ˈfai/
falce	/ˈfaltʃe/
falcone	/falkˈone/
fallace	/fallˈatʃe/
falla	/ˈfalla/
falli	/ˈfalli/
fallire	/fallˈire/
fallo	/ˈfallo/
falsa	/ˈfalsa/
falsamente	/falsamˈente/
false	/ˈfalse/
falsi	/ˈfalsi/
falsità	/falsitˈa/
falso	/ˈfalso/
fama	/ˈfama/
fame	/ˈfame/
famiglia	/famˈiʎʎa/
famigliare	/famiʎʎˈare/
famigliari	/famiʎʎˈari/
famiglie	/famˈiʎʎe/
famiglio	/famˈiʎʎo/
famosa	/famˈosa/
famose	/famˈose/
famosi	/famˈosi/
famosissima	/famosˈissima/
famosissimi	/famosˈissimi/
famosissimo	/famosˈissimo/
famoso	/famˈoso/
fanciulla	/fantʃˈulla/
fanciulle	/fantʃˈulle/
fanciullezza	/fantʃullˈetstsa/
fanciulli	/fantʃˈulli/
fanciullo	/fantʃˈullo/
fango	/ˈfaŋɡo/
fanno	/ˈfanno/
fantasia	/fantazˈia/
fante	/ˈfante/
fanti	/ˈfanti/
farai	/farˈai/
faranno	/farˈanno/
farci	/ˈfartʃi/
farebbe	/farˈɛbbe/
fare	/ˈfare/
farei	/farˈɛi/
faremo	/farˈemo/
fareste	/farˈeste/
faresti	/farˈesti/
farete	/farˈete/
farsetto	/farsˈetto/
fascio	/ˈfaʃʃo/
fasi	/ˈfazi/
fassi	/ˈfassi/
fastidio	/fastˈidjo/
fatale	/fatˈale/
fate	/ˈfate/
fatica	/fatˈika/
fatiche	/fatˈike/
fati	/ˈfati/
fato	/ˈfato/
fatta	/ˈfatta/
fattamente	/fattamˈente/
fatte	/ˈfatte/
fattezze	/fattˈetstse/
fatti	/ˈfatti/
fatto	/ˈfatto/
fattore	/fattˈore/
fatua	/ˈfatua/
fauci	/ˈfautʃi/
fauna	/ˈfauna/
fauni	/ˈfauni/
fauno	/ˈfauno/
favella	/favˈɛlla/
favellando	/favellˈando/
favellare	/favellˈare/
favelle	/favˈɛlle/
favilla	/favˈilla/
faville	/favˈille/
favola	/ˈfavola/
favole	/ˈfavole/
favolosa	/favolˈosa/
favolosi	/favolˈosi/
favoloso	/favolˈoso/
favore	/favˈore/
favorevole	/favorˈevole/
favorevoli	/favorˈevoli/
favorisce	/favorˈiʃʃe/
favorito	/favorˈito/
febbre	/ˈfɛbbre/
feccia	/ˈfɛtʃtʃa/
fece	/ˈfetʃe/
fecero	/ˈfetʃero/
feci	/ˈfɛtʃi/
fede	/ˈfede/
fedele	/fedˈele/
fedel	/fedˈel/
fedeli	/fedˈeli/
fedelissimo	/fedelˈissimo/
fedelmente	/fedelmˈente/
federazione	/federatstsjˈone/
federigo	/federˈiɡo/
fe	/ˈfe/
fé	/ˈfe/
felice	/felˈitʃe/
felicemente	/felitʃemˈente/
felici	/felˈitʃi/
felicità	/felitʃitˈa/
fenici	/fenˈitʃi/
fera	/ˈfɛra/
ferendo	/ferˈɛndo/
ferì	/ferˈi/
ferire	/ferˈire/
ferita	/ferˈita/
ferite	/ferˈite/
feriti	/ferˈiti/
ferito	/ferˈito/
ferma	/ˈferma/
fermamente	/fermamˈente/
fermare	/fermˈare/
fermarono	/fermˈarono/
fermata	/fermˈata/
fermati	/fermˈati/
fermato	/fermˈato/
ferme	/ˈferme/
fermezza	/fermˈetstsa/
fermi	/ˈfermi/
fermo	/ˈfɛrmo/
fermò	/fermˈɔ/
feroce	/ferˈotʃe/
feroci	/ferˈotʃi/
ferocissimo	/ferotʃˈissimo/
ferrara	/ferrˈara/
ferri	/ˈfɛrri/
ferro	/ˈfɛrro/
fertile	/ˈfɛrtile/
fervente	/fervˈɛnte/
ferventemente	/ferventemˈente/
ferventissimo	/ferventˈissimo/
fervore	/fervˈore/
fessure	/fessˈure/
festa	/ˈfɛsta/
feste	/ˈfɛste/
festeggiare	/festedʒdʒˈare/
festevole	/festˈevole/
fia	/ˈfia/
fiamma	/fjˈamma/
fiammetta	/fjammˈetta/
fianchi	/fjˈaŋki/
fianco	/fjˈaŋko/
fiasco	/fjˈasko/
fiata	/fjˈata/
fiate	/fjˈate/
fiato	/fjˈato/
fida	/ˈfida/
fidanza	/fidˈantsa/
fidava	/fidˈava/
fido	/ˈfido/
fie	/ˈfie/
fieno	/fjˈɛno/
fiera	/fjˈɛra/
fieramente	/fjeramˈente/
fiere	/fjˈɛre/
fierezza	/fjerˈetstsa/
fieri	/fjˈɛri/
fiero	/fjˈɛro/
fievole	/fjˈɛvole/
figlia	/ˈfiʎʎa/
figli	/ˈfiʎʎi/
figlio	/ˈfiʎʎo/
figlioli	/fiʎʎˈɔli/
figliolo	/fiʎʎˈɔlo/
figliuola	/fiʎʎwˈɔla/
figmenti	/fiɡmˈenti/
figmento	/fiɡmˈento/
figura	/fiɡˈura/
figurato	/fiɡurˈato/
figure	/fiɡˈure/
fila	/ˈfila/
fili	/ˈfili/
filippo	/filˈippo/
filo	/ˈfilo/
filomena	/filomˈɛna/
filosofanti	/filozofˈanti/
filosofia	/filozofˈia/
filosofica	/filozˈɔfika/
filosofico	/filozˈɔfiko/
filosofi	/filˈɔzofi/
filosofo	/filˈɔzofo/
finale	/finˈale/
finalità	/finalitˈa/
finalmente	/finalmˈente/
fine	/ˈfine/
finestra	/finˈɛstra/
finestre	/finˈɛstre/
finge	/ˈfindʒe/
fingendo	/findʒˈɛndo/
fingere	/ˈfindʒere/
fingono	/ˈfiŋɡono/
fini	/ˈfini/
finì	/finˈi/
finire	/finˈire/
finisce	/finˈiʃʃe/
finiscono	/finˈiskono/
finisse	/finˈisse/
finita	/finˈita/
finite	/finˈite/
finito	/finˈito/
fino	/ˈfino/
finsero	/ˈfinsero/
finta	/ˈfinta/
finto	/ˈfinto/
fiore	/fjˈore/
fiorentina	/fjorentˈina/
fiorentini	/fjorentˈini/
fiorentino	/fjorentˈino/
fiorenza	/fjorˈɛntsa/
fiori	/fjˈori/
fiorin	/fjorˈin/
fiorini	/fjorˈini/
firenze	/firˈɛntse/
fisica	/ˈfizika/
fisici	/ˈfizitʃi/
fiso	/ˈfizo/
fissi	/ˈfissi/
fisso	/ˈfisso/
fissò	/fissˈɔ/
fistola	/ˈfistola/
fitone	/fitˈone/
fiume	/fjˈume/
fiumi	/fjˈumi/
flora	/flˈɔra/
florio	/flˈɔrjo/
foci	/ˈfotʃi/
foco	/ˈfɔko/
focosamente	/fokosamˈente/
focosi	/fokˈosi/
focoso	/fokˈoso/
fo	/ˈfɔ/
foga	/ˈfoɡa/
foglie	/ˈfɔʎʎe/
foglio	/ˈfɔʎʎo/
folco	/ˈfolko/
folgore	/ˈfolɡore/
folgori	/ˈfolɡori/
folla	/ˈfolla/
folle	/ˈfɔlle/
follia	/follˈia/
folli	/ˈfɔlli/
folta	/ˈfolta/
fondaco	/ˈfondako/
fondamentale	/fondamentˈale/
fondamenti	/fondamˈenti/
fondamento	/fondamˈento/
fondatori	/fondatˈori/
fondo	/ˈfondo/
fontana	/fontˈana/
fontane	/fontˈane/
fora	/ˈfɔra/
forche	/ˈforke/
forese	/forˈese/
forestiere	/forestjˈɛre/
forestieri	/forestjˈɛri/
forma	/ˈforma/
formale	/formˈale/
formano	/ˈformano/
formare	/formˈare/
formata	/formˈata/
formato	/formˈato/
forme	/ˈforme/
formiche	/formˈike/
formò	/formˈɔ/
formula	/ˈfɔrmula/
fornaio	/fornˈajo/
fornire	/fornˈire/
fornita	/fornˈita/
fornito	/fornˈito/
forse	/ˈforse/
forte	/ˈfɔrte/
fortemente	/fortemˈente/
fortezza	/fortˈetstsa/
forti	/ˈfɔrti/
fortissima	/fortˈissima/
fortissimi	/fortˈissimi/
fortissimo	/fortˈissimo/
fortuna	/fortˈuna/
fortune	/fortˈune/
fortunosi	/fortunˈosi/
forza	/ˈfɔrtsa/
forze	/ˈfɔrtse/
fossa	/ˈfɔssa/
fosse	/ˈfɔsse/
fossero	/ˈfossero/
fossi	/ˈfɔssi/
fossimo	/ˈfossimo/
foste	/ˈfoste/
fosti	/ˈfosti/
fra	/frˈa/
fragilità	/fradʒilitˈa/
frale	/frˈale/
francesca	/frantʃˈeska/
francesco	/frantʃˈesko/
francese	/frantʃˈeze/
francia	/frˈantʃa/
frase	/frˈaze/
frasi	/frˈazi/
frate	/frˈate/
fratelli	/fratˈɛlli/
fratello	/fratˈɛllo/
fredda	/frˈedda/
fredde	/frˈedde/
freddezza	/freddˈetstsa/
freddi	/frˈeddi/
freddo	/frˈeddo/
fremito	/frˈɛmito/
freni	/frˈɛni/
freno	/frˈɛno/
fresca	/frˈeska/
fresche	/frˈeske/
freschi	/frˈeski/
fresco	/frˈesko/
fretta	/frˈetta/
frigia	/frˈidʒa/
frigidità	/fridʒiditˈa/
friso	/frˈizo/
friuli	/friˈuli/
frode	/frˈɔde/
fronda	/frˈonda/
fronde	/frˈonde/
frondi	/frˈondi/
fronte	/frˈonte/
frutti	/frˈutti/
frutto	/frˈutto/
fù	/ˈfu/
fuga	/ˈfuɡa/
fugga	/ˈfuɡɡa/
fugge	/ˈfudʒdʒe/
fuggendo	/fudʒdʒˈɛndo/
fuggì	/fudʒdʒˈi/
fuggire	/fudʒdʒˈire/
fuggirono	/fudʒdʒˈirono/
fuggisse	/fudʒdʒˈisse/
fuggita	/fudʒdʒˈita/
fuggiti	/fudʒdʒˈiti/
fuggito	/fudʒdʒˈito/
fuggiva	/fudʒdʒˈiva/
fuggono	/ˈfuɡɡono/
fui	/ˈfui/
fulminata	/fulminˈata/
fulminato	/fulminˈato/
fummo	/ˈfummo/
fumo	/ˈfumo/
fune	/ˈfune/
fuochi	/fwˈɔki/
fuoco	/fwˈɔko/
fuori	/fwˈɔri/
furia	/ˈfurja/
furie	/ˈfurje/
furiosa	/furjˈosa/
furiosamente	/furjosamˈente/
furiosi	/furjˈosi/
furioso	/furjˈoso/
furono	/ˈfurono/
furore	/furˈore/
furtivamente	/furtivamˈente/
furto	/ˈfurto/
fusse	/ˈfusse/
futura	/futˈura/
future	/futˈure/
futuri	/futˈuri/
futuro	/futˈuro/
gabriello	/ɡabrjˈɛllo/
gagliarda	/ɡaʎʎˈarda/
gagliardo	/ɡaʎʎˈardo/
gaio	/ˈɡajo/
galea	/ɡalˈɛa/
galee	/ɡalˈɛe/
galileo	/ɡalilˈɛo/
galle	/ˈɡalle/
gallica	/ˈɡallika/
galline	/ɡallˈine/
gallo	/ˈɡallo/
gamba	/ˈɡamba/
gambe	/ˈɡambe/
ganimede	/ɡanimˈɛde/
gara	/ˈɡara/
garbo	/ˈɡarbo/
garibaldi	/ɡaribˈaldi/
garzone	/ɡardzˈone/
garzoni	/ɡardzˈoni/
gastaldo	/ɡastˈaldo/
geloso	/dʒelˈoso/
gemme	/ˈdʒɛmme/
geneologia	/dʒeneolodʒˈia/
genera	/ˈdʒɛnera/
generale	/dʒenerˈale/
generali	/dʒenerˈali/
generalmente	/dʒeneralmˈente/
generare	/dʒenerˈare/
generasse	/dʒenerˈasse/
generata	/dʒenerˈata/
generati	/dʒenerˈati/
generato	/dʒenerˈato/
generazione	/dʒeneratstsjˈone/
genere	/ˈdʒɛnere/
generi	/ˈdʒɛneri/
genero	/ˈdʒɛnero/
generò	/dʒenerˈɔ/
generosa	/dʒenerˈosa/
generosi	/dʒenerˈosi/
generosità	/dʒenerositˈa/
generoso	/dʒenerˈoso/
genio	/ˈdʒɛnjo/
genova	/ˈdʒɛnova/
genovese	/dʒenovˈese/
genovesi	/dʒenovˈesi/
gente	/ˈdʒɛnte/
genti	/ˈdʒɛnti/
gentile	/dʒentˈile/
gentilezza	/dʒentilˈetstsa/
gentili	/dʒentˈili/
gentiluomo	/dʒentilwˈɔmo/
geometria	/dʒeometrˈia/
georgica	/dʒeˈɔrdʒika/
gerbino	/ˈdʒɛrbino/
geri	/ˈdʒeri/
ghiaccio	/ɡjˈatʃtʃo/
ghirlanda	/ɡirlˈanda/
ghirlande	/ɡirlˈande/
giace	/ˈdʒatʃe/
giacere	/dʒatʃˈere/
giacesse	/dʒatʃˈesse/
giaceva	/dʒatʃˈeva/
giacitura	/dʒatʃitˈura/
giacomino	/dʒakomˈino/
giacque	/ˈdʒakkwe/
già	/ˈdʒa/
gia	/ˈdʒia/
giamai	/dʒamˈai/
giammai	/dʒammˈai/
gianni	/ˈdʒanni/
giardini	/dʒardˈini/
giardino	/dʒardˈino/
giesù	/dʒezˈu/
gigante	/dʒiɡˈante/
giganti	/dʒiɡˈanti/
gilberto	/dʒilbˈɛrto/
ginocchio	/dʒinˈɔkkjo/
giogo	/ˈdʒoɡo/
gioia	/ˈdʒɔja/
giornata	/dʒornˈata/
giornate	/dʒornˈate/
giorni	/ˈdʒorni/
giorno	/ˈdʒorno/
giova	/ˈdʒova/
giovamento	/dʒovamˈento/
giovan	/dʒovˈan/
giovane	/ˈdʒovane/
giovanetta	/dʒovanˈetta/
giovanetto	/dʒovanˈetto/
giovani	/ˈdʒovani/
giovanili	/dʒovanˈili/
giovanni	/dʒovˈanni/
giovano	/ˈdʒovano/
giovare	/dʒovˈare/
giove	/ˈdʒɔve/
gioventù	/dʒoventˈu/
giovevole	/dʒovˈevole/
giovine	/ˈdʒovine/
giovinezza	/dʒovinˈetstsa/
gira	/ˈdʒira/
girare	/dʒirˈare/
girato	/dʒirˈato/
giri	/ˈdʒiri/
giro	/ˈdʒiro/
girolamo	/dʒirˈɔlamo/
gita	/ˈdʒita/
gittata	/dʒittˈata/
gittate	/dʒittˈate/
giudaica	/dʒudˈaika/
giudei	/dʒudˈɛi/
giudeo	/dʒudˈɛo/
giudica	/ˈdʒudika/
giudicando	/dʒudikˈando/
giudicare	/dʒudikˈare/
giudicata	/dʒudikˈata/
giudicato	/dʒudikˈato/
giudicava	/dʒudikˈava/
giudice	/ˈdʒuditʃe/
giudici	/ˈdʒuditʃi/
giudico	/ˈdʒudiko/
giudizio	/dʒudˈitstsjo/
giù	/ˈdʒu/
giulia	/ˈdʒulja/
giuliano	/dʒuljˈano/
giulio	/ˈdʒuljo/
giunga	/ˈdʒuŋɡa/
giunge	/ˈdʒundʒe/
giungere	/ˈdʒundʒere/
giunse	/ˈdʒunse/
giunsero	/ˈdʒunsero/
giunta	/ˈdʒunta/
giunte	/ˈdʒunte/
giunti	/ˈdʒunti/
giunto	/ˈdʒunto/
giuochi	/dʒwˈɔki/
giuoco	/dʒwˈɔko/
giuramento	/dʒuramˈento/
giurando	/dʒurˈando/
giurare	/dʒurˈare/
giuro	/ˈdʒuro/
giurò	/dʒurˈɔ/
giuseppe	/dʒuzˈɛppe/
giuso	/ˈdʒuzo/
giusta	/ˈdʒusta/
giustamente	/dʒustamˈente/
giusti	/ˈdʒusti/
giustino	/dʒustˈino/
giustizia	/dʒustˈitstsja/
giusto	/ˈdʒusto/
glauca	/ɡlˈauka/
glauco	/ɡlˈauko/
gliele	/ˈʎele/
glielo	/ˈʎelo/
gliene	/ˈʎene/
gli	/ˈʎi/
gloria	/ɡlˈɔrja/
gloriosa	/ɡlorjˈosa/
gloriosi	/ɡlorjˈosi/
glorioso	/ɡlorjˈoso/
gode	/ˈɡɔde/
godere	/ɡodˈere/
gola	/ˈɡola/
gorgo	/ˈɡorɡo/
gostanza	/ɡostˈantsa/
governare	/ɡovernˈare/
governatore	/ɡovernatˈore/
governo	/ɡovˈɛrno/
gradazione	/ɡradatstsjˈone/
gradi	/ɡrˈadi/
gradimento	/ɡradimˈento/
grado	/ɡrˈado/
gramigna	/ɡramˈiɲɲa/
grande	/ɡrˈande/
grandemente	/ɡrandemˈente/
grandezza	/ɡrandˈetstsa/
grandi	/ɡrˈandi/
grandissima	/ɡrandˈissima/
grandissime	/ɡrandˈissime/
grandissimi	/ɡrandˈissimi/
grandissimo	/ɡrandˈissimo/
grani	/ɡrˈani/
grano	/ɡrˈano/
grata	/ɡrˈata/
gratitudine	/ɡratitˈudine/
grato	/ɡrˈato/
gratuita	/ɡratˈuita/
grava	/ɡrˈava/
grave	/ɡrˈave/
gravemente	/ɡravemˈente/
gravezza	/ɡravˈetstsa/
gravida	/ɡrˈavida/
gravi	/ɡrˈavi/
gravissima	/ɡravˈissima/
gravissime	/ɡravˈissime/
gravissimo	/ɡravˈissimo/
gravità	/ɡravitˈa/
gravosa	/ɡravˈosa/
gravoso	/ɡravˈoso/
grazia	/ɡrˈatstsja/
grazie	/ɡrˈatstsje/
graziosa	/ɡratstsjˈosa/
graziosamente	/ɡratstsjosamˈente/
graziose	/ɡratstsjˈose/
graziosi	/ɡratstsjˈosi/
grazioso	/ɡratstsjˈoso/
greca	/ɡrˈɛka/
greche	/ɡrˈɛke/
grecia	/ɡrˈɛtʃa/
greci	/ɡrˈɛtʃi/
greco	/ɡrˈɛko/
gregge	/ɡrˈedʒdʒe/
greggi	/ɡrˈedʒdʒi/
grembo	/ɡrˈɛmbo/
greve	/ɡrˈɛve/
grida	/ɡrˈida/
gridando	/ɡridˈando/
gridare	/ɡridˈare/
gridava	/ɡridˈava/
gridi	/ɡrˈidi/
grido	/ɡrˈido/
grossa	/ɡrˈɔssa/
grosse	/ɡrˈɔsse/
grossezza	/ɡrossˈetstsa/
grossi	/ɡrˈɔssi/
grosso	/ɡrˈɔsso/
grotta	/ɡrˈɔtta/
grotte	/ɡrˈɔtte/
guadagnare	/ɡwadaɲɲˈare/
guadagnata	/ɡwadaɲɲˈata/
guadagnato	/ɡwadaɲɲˈato/
guadagni	/ɡwadˈaɲɲi/
guadagno	/ɡwadˈaɲɲo/
guai	/ɡwˈai/
gualtieri	/ɡwaltjˈeri/
guance	/ɡwˈantʃe/
guarda	/ɡwˈarda/
guardando	/ɡwardˈando/
guardano	/ɡwˈardano/
guardare	/ɡwardˈare/
guardasse	/ɡwardˈasse/
guardata	/ɡwardˈata/
guardate	/ɡwardˈate/
guardati	/ɡwardˈati/
guardato	/ɡwardˈato/
guardava	/ɡwardˈava/
guardiano	/ɡwardjˈano/
guardi	/ɡwˈardi/
guardino	/ɡwˈardino/
guardo	/ɡwˈardo/
guardò	/ɡwardˈɔ/
guari	/ɡwˈari/
guasta	/ɡwˈasta/
guastare	/ɡwastˈare/
guasti	/ɡwˈasti/
guasto	/ɡwˈasto/
guerra	/ɡwˈɛrra/
guerre	/ɡwˈɛrre/
guerriero	/ɡwerrjˈɛro/
guida	/ɡwˈida/
guidano	/ɡwˈidano/
guidare	/ɡwidˈare/
guidata	/ɡwidˈata/
guidati	/ɡwidˈati/
guidato	/ɡwidˈato/
guidava	/ɡwidˈava/
guiderdone	/ɡwiderdˈone/
guidi	/ɡwˈidi/
guido	/ɡwˈido/
guisa	/ɡwˈiza/
guise	/ɡwˈize/
gustare	/ɡustˈare/
gustato	/ɡustˈato/
gusto	/ˈɡusto/
ha	/ˈa/
hai	/ˈai/
hanno	/ˈanno/
helena	/elˈɛna/
ho	/ˈo/
ida	/ˈida/
iddii	/iddˈii/
iddio	/iddˈio/
idea	/idˈɛa/
ideale	/ideˈale/
idee	/idˈɛe/
ideo	/idˈɛo/
idioma	/idjˈɔma/
ieri	/ˈjɛri/
ignominia	/iɲɲomˈinja/
ignorante	/iɲɲorˈante/
ignoranti	/iɲɲorˈanti/
ignoranza	/iɲɲorˈantsa/
ignorava	/iɲɲorˈava/
ignoto	/iɲɲˈɔto/
ignuda	/iɲɲˈuda/
ignude	/iɲɲˈude/
ignudi	/iɲɲˈudi/
ignudo	/iɲɲˈudo/
iguale	/iɡwˈale/
iguali	/iɡwˈali/
ilario	/ilˈarjo/
il	/ˈil/
ilia	/ˈilja/
illusione	/illuzjˈone/
illusioni	/illuzjˈoni/
illustre	/illˈustre/
illustri	/illˈustri/
illustrissima	/illustrˈissima/
imaginando	/imadʒinˈando/
imbarazzo	/imbarˈatstso/
imitando	/imitˈando/
immagini	/immˈadʒini/
immediatamente	/immedjatamˈente/
immobile	/immˈɔbile/
immortale	/immortˈale/
immortali	/immortˈali/
impaziente	/impatstsjˈɛnte/
impazienza	/impatstsjˈɛntsa/
impedimento	/impedimˈento/
impedita	/impedˈita/
impedito	/impedˈito/
imperadore	/imperadˈore/
imperadori	/imperadˈori/
imperatore	/imperatˈore/
imperio	/impˈɛrjo/
impeto	/ˈimpeto/
impetuoso	/impetuˈoso/
implacabile	/implakˈabile/
importa	/impˈɔrta/
impose	/impˈose/
impossibile	/impossˈibile/
impossibili	/impossˈibili/
imposte	/impˈɔste/
imposto	/impˈɔsto/
impregnata	/impreɲɲˈata/
impregnò	/impreɲɲˈɔ/
imprendere	/imprˈɛndere/
impresa	/imprˈesa/
imprese	/imprˈese/
impressione	/impressjˈone/
improvvisamente	/improvvizamˈente/
improvviso	/improvvˈizo/
impulso	/impˈulso/
inanzi	/inˈantsi/
incanti	/iŋkˈanti/
incapace	/iŋkapˈatʃe/
incarnazione	/iŋkarnatstsjˈone/
incendia	/intʃˈɛndja/
incendio	/intʃˈɛndjo/
incerta	/intʃˈɛrta/
incerto	/intʃˈɛrto/
inchinati	/iŋkinˈati/
inchinato	/iŋkinˈato/
inclito	/ˈiŋklito/
incominciai	/iŋkomintʃˈai/
incomincia	/iŋkomˈintʃa/
incominciando	/iŋkomintʃˈando/
incominciano	/iŋkomˈintʃano/
incominciare	/iŋkomintʃˈare/
incominciarono	/iŋkomintʃˈarono/
incominciasse	/iŋkomintʃˈasse/
incominciata	/iŋkomintʃˈata/
incominciato	/iŋkomintʃˈato/
incominciava	/iŋkomintʃˈava/
incominci	/iŋkomˈintʃi/
incominciò	/iŋkomintʃˈɔ/
incomparabile	/iŋkomparˈabile/
incontanente	/iŋkontanˈɛnte/
incontro	/iŋkˈontro/
inconvenevolmente	/iŋkonfvenevolmˈente/
incorrere	/iŋkˈorrere/
indarno	/indˈarno/
indice	/indˈitʃe/
indietro	/indjˈɛtro/
indifferente	/indifferˈɛnte/
indi	/ˈindi/
indirizzo	/indirˈitstso/
individuale	/individuˈale/
indizio	/indˈitstsjo/
indole	/ˈindole/
indosso	/indˈɔsso/
indovinare	/indovinˈare/
indovino	/indovˈino/
induce	/indˈutʃe/
indugio	/indˈudʒo/
industria	/indˈustrja/
ineffabile	/ineffˈabile/
inestimabile	/inestimˈabile/
infallibile	/inffallˈibile/
infame	/inffˈame/
infamia	/inffˈamja/
infatti	/inffˈatti/
infelice	/inffelˈitʃe/
infelicemente	/inffelitʃemˈente/
infelici	/inffelˈitʃi/
inferiore	/infferjˈore/
inferiori	/infferjˈori/
inferma	/inffˈerma/
infermi	/inffˈermi/
infermità	/inffermitˈa/
infermo	/inffˈermo/
infermò	/inffermˈɔ/
infernale	/inffernˈale/
infernali	/inffernˈali/
inferno	/inffˈɛrno/
infiammata	/inffjammˈata/
infiammati	/inffjammˈati/
infiammato	/inffjammˈato/
infima	/ˈinffima/
infine	/inffˈine/
infinita	/inffinˈita/
infinite	/inffinˈite/
infiniti	/inffinˈiti/
infinito	/inffinˈito/
infino	/inffˈino/
informato	/infformˈato/
informazione	/infformatstsjˈone/
informazioni	/infformatstsjˈoni/
infortunii	/inffortˈunji/
infortunio	/inffortˈunjo/
ingannare	/iŋɡannˈare/
ingannata	/iŋɡannˈata/
ingannati	/iŋɡannˈati/
ingannato	/iŋɡannˈato/
inganni	/iŋɡˈanni/
inganno	/iŋɡˈanno/
ingegnati	/indʒeɲɲˈati/
ingegnato	/indʒeɲɲˈato/
ingegni	/indʒˈeɲɲi/
ingegno	/indʒˈeɲɲo/
inghilterra	/iŋɡiltˈɛrra/
inghiottita	/iŋɡjottˈita/
ingiuria	/indʒˈurja/
ingiurie	/indʒˈurje/
ingiusta	/indʒˈusta/
ingiustamente	/indʒustamˈente/
ingiusto	/indʒˈusto/
ingordigia	/iŋɡordˈidʒa/
ingrata	/iŋɡrˈata/
in	/ˈin/
inimica	/inimˈika/
inimici	/inimˈitʃi/
inimico	/inimˈiko/
iniqua	/inˈikwa/
inique	/inˈikwe/
iniqui	/inˈikwi/
iniquità	/inikwitˈa/
iniquo	/inˈikwo/
iniziale	/initstsjˈale/
iniziativa	/initstsjatˈiva/
innamoramento	/innamoramˈento/
innamorare	/innamorˈare/
innamorata	/innamorˈata/
innamorate	/innamorˈate/
innamorati	/innamorˈati/
innamorato	/innamorˈato/
innanzi	/innˈantsi/
innocente	/innotʃˈɛnte/
innocenti	/innotʃˈɛnti/
inquisitore	/iŋkwizitˈore/
insegna	/insˈeɲɲa/
insegnare	/inseɲɲˈare/
insegnato	/inseɲɲˈato/
insegne	/insˈeɲɲe/
insegnò	/inseɲɲˈɔ/
insensibili	/insensˈibili/
insidie	/insˈidje/
insieme	/insjˈɛme/
insiememente	/insjememˈente/
insino	/insˈino/
insistente	/insistˈɛnte/
insomma	/insˈomma/
intanto	/intˈanto/
intelletto	/intellˈɛtto/
intelligenza	/intellidʒˈɛntsa/
intenda	/intˈɛnda/
intende	/intˈɛnde/
intendendo	/intendˈɛndo/
intendente	/intendˈɛnte/
intendere	/intˈɛndere/
intendeva	/intendˈeva/
intendiamo	/intendjˈamo/
intendi	/intˈɛndi/
intendimento	/intendimˈento/
intendo	/intˈɛndo/
intendono	/intˈɛndono/
intensa	/intˈɛnsa/
intensamente	/intensamˈente/
intenti	/intˈɛnti/
intento	/intˈɛnto/
intenzione	/intentsjˈone/
intera	/intˈera/
interamente	/interamˈente/
intere	/intˈere/
interesse	/interˈɛsse/
interessi	/interˈɛssi/
inter	/ˈinter/
interi	/intˈeri/
interiora	/interjˈora/
intero	/intˈero/
interpretata	/interpretˈata/
interpretato	/interpretˈato/
interprete	/intˈɛrprete/
interpreti	/intˈɛrpreti/
interrotto	/interrˈotto/
intervenire	/intervenˈire/
intervenuto	/intervenˈuto/
intesa	/intˈesa/
intese	/intˈese/
intesi	/intˈesi/
inteso	/intˈeso/
intiero	/intjˈɛro/
intima	/intˈima/
intitolò	/intitolˈɔ/
intollerabile	/intollerˈabile/
intorno	/intˈorno/
introduce	/introdˈutʃe/
introduzione	/introdutstsjˈone/
inutile	/inˈutile/
invano	/infvˈano/
invece	/infvˈetʃe/
inventore	/infventˈore/
inventori	/infventˈori/
inverso	/infvˈɛrso/
investigazione	/infvestiɡatstsjˈone/
invia	/infvˈia/
invidia	/infvˈidja/
invidiosa	/infvidjˈosa/
invidiosi	/infvidjˈosi/
invidioso	/infvidjˈoso/
invitati	/infvitˈati/
invitato	/infvitˈato/
involto	/infvˈɔlto/
io	/ˈio/
iole	/ˈjɔle/
ione	/ˈjone/
ionio	/ˈjɔnjo/
ira	/ˈira/
ire	/ˈire/
iris	/ˈiris/
ischia	/ˈiskja/
iside	/ˈizide/
isidoro	/izidˈɔro/
isola	/ˈizola/
isole	/ˈizole/
istante	/istˈante/
istessa	/istˈessa/
istesse	/istˈesse/
istesso	/istˈesso/
istoria	/istˈɔrja/
ita	/ˈita/
italia	/itˈalja/
italiana	/italjˈana/
italiani	/italjˈani/
italiano	/italjˈano/
ito	/ˈito/
ivi	/ˈivi/
labbra	/ˈlabbra/
labbro	/ˈlabbro/
laccio	/ˈlatʃtʃo/
lacedemone	/latʃedˈɛmone/
lacedemoni	/latʃedˈɛmoni/
lacerato	/latʃerˈato/
ladri	/ˈladri/
ladro	/ˈladro/
ladrone	/ladrˈone/
ladroni	/ladrˈoni/
laggiù	/ladʒdʒˈu/
laghi	/ˈlaɡi/
lago	/ˈlaɡo/
lagrima	/ˈlaɡrima/
lagrime	/ˈlaɡrime/
la	/ˈla/
là	/ˈla/
l'altra	/ˈlaltra/
l'amara	/lamˈara/
lamenti	/lamˈenti/
lamento	/lamˈento/
lampada	/ˈlampada/
lampo	/ˈlampo/
lana	/ˈlana/
lance	/ˈlantʃe/
lancia	/ˈlantʃa/
l'anime	/ˈlanime/
l'animo	/ˈlanimo/
lanterna	/lantˈɛrna/
l'aquila	/ˈlakwila/
larga	/ˈlarɡa/
largamente	/larɡamˈente/
larghe	/ˈlarɡe/
largo	/ˈlarɡo/
lasciai	/laʃʃˈai/
lascia	/ˈlaʃʃa/
lasciamo	/laʃʃˈamo/
lasciando	/laʃʃˈando/
lasciano	/ˈlaʃʃano/
lasciare	/laʃʃˈare/
lasciarono	/laʃʃˈarono/
lasciasse	/laʃʃˈasse/
lasciassero	/laʃʃˈassero/
lasciasti	/laʃʃˈasti/
lasciata	/laʃʃˈata/
lasciate	/laʃʃˈate/
lasciati	/laʃʃˈati/
lasciato	/laʃʃˈato/
lasciava	/laʃʃˈava/
lasciavano	/laʃʃˈavano/
lascierò	/laʃʃerˈɔ/
lasci	/ˈlaʃʃi/
lascino	/ˈlaʃʃino/
lascio	/ˈlaʃʃo/
lasciò	/laʃʃˈɔ/
lascivia	/laʃʃˈivja/
lascivie	/laʃʃˈivje/
lascivi	/laʃʃˈivi/
lascivo	/laʃʃˈivo/
lassi	/ˈlassi/
lasso	/ˈlasso/
lassù	/lassˈu/
lati	/ˈlati/
latina	/latˈina/
latinamente	/latinamˈente/
latine	/latˈine/
latini	/latˈini/
latino	/latˈino/
lato	/ˈlato/
latrare	/latrˈare/
latte	/ˈlatte/
laude	/ˈlaude/
laura	/ˈlaura/
laurea	/ˈlaurea/
laurenti	/laurˈɛnti/
lauretta	/laurˈetta/
lauro	/ˈlauro/
lavacro	/lavˈakro/
lavare	/lavˈare/
lavato	/lavˈato/
lavinia	/lavˈinja/
lavorare	/lavorˈare/
lavoratore	/lavoratˈore/
lavoratori	/lavoratˈori/
lavorava	/lavorˈava/
lavorio	/lavorˈio/
lavoro	/lavˈoro/
lazzaretto	/ladzdzarˈetto/
leale	/leˈale/
lealmente	/lealmˈente/
lealtà	/lealtˈa/
leandro	/leˈandro/
learco	/leˈarko/
lecito	/ˈletʃito/
leda	/ˈlɛda/
lega	/ˈleɡa/
legame	/leɡˈame/
legami	/leɡˈami/
legare	/leɡˈare/
legarono	/leɡˈarono/
legata	/leɡˈata/
legate	/leɡˈate/
legati	/leɡˈati/
legato	/leɡˈato/
legga	/ˈlɛɡɡa/
leggano	/ˈlɛɡɡano/
legge	/ˈlɛdʒdʒe/
leggendo	/ledʒdʒˈɛndo/
leggeranno	/ledʒdʒerˈanno/
leggere	/ˈlɛdʒdʒere/
leggiadra	/ledʒdʒˈadra/
leggiadramente	/ledʒdʒadramˈente/
leggiadre	/ledʒdʒˈadre/
leggiadria	/ledʒdʒadrˈia/
leggiadri	/ledʒdʒˈadri/
leggiadro	/ledʒdʒˈadro/
leggiamo	/ledʒdʒˈamo/
leggiera	/ledʒdʒˈɛra/
leggiere	/ledʒdʒˈɛre/
leggieri	/ledʒdʒˈɛri/
leggiero	/ledʒdʒˈɛro/
leggi	/ˈlɛdʒdʒi/
leggono	/ˈlɛɡɡono/
legittima	/ledʒˈittima/
legne	/ˈleɲɲe/
legni	/ˈleɲɲi/
legno	/ˈleɲɲo/
legò	/leɡˈɔ/
lei	/ˈlɛi/
le	/le/
lelio	/ˈlɛljo/
lena	/ˈlena/
lentamente	/lentamˈente/
lente	/ˈlɛnte/
lenti	/ˈlɛnti/
lento	/ˈlɛnto/
leonardo	/leonˈardo/
leone	/leˈone/
leoni	/leˈoni/
letizia	/letˈitstsja/
lette	/ˈlɛtte/
lettera	/ˈlɛttera/
letterarie	/letterˈarje/
lettere	/ˈlɛttere/
letti	/ˈlɛtti/
letto	/ˈlɛtto/
lettore	/lettˈore/
lettori	/lettˈori/
lettura	/lettˈura/
levai	/levˈai/
leva	/ˈlɛva/
levando	/levˈando/
levano	/ˈlɛvano/
levare	/levˈare/
levarono	/levˈarono/
levasse	/levˈasse/
levata	/levˈata/
levate	/levˈate/
levati	/levˈati/
levato	/levˈato/
levava	/levˈava/
levi	/ˈlɛvi/
levò	/levˈɔ/
lezzo	/ˈledzdzo/
liberale	/liberˈale/
libera	/ˈlibera/
liberali	/liberˈali/
liberalità	/liberalitˈa/
liberare	/liberˈare/
liberata	/liberˈata/
liberato	/liberˈato/
liberazione	/liberatstsjˈone/
libere	/ˈlibere/
liberi	/ˈliberi/
liber	/ˈliber/
libero	/ˈlibero/
liberò	/liberˈɔ/
libertà	/libertˈa/
libia	/ˈlibja/
libidine	/libˈidine/
libidinoso	/libidinˈoso/
libretto	/librˈetto/
libri	/ˈlibri/
libro	/ˈlibro/
licaone	/likaˈone/
licenza	/litʃˈɛntsa/
licenze	/litʃˈɛntse/
licenzia	/litʃˈɛntsja/
licenziò	/litʃentsjˈɔ/
licenziosamente	/litʃentsjosamˈente/
liceo	/litʃˈɛo/
licia	/ˈlitʃa/
licito	/ˈlitʃito/
lidia	/ˈlidja/
lido	/ˈlido/
lieta	/ljˈɛta/
lietamente	/ljetamˈente/
liete	/ljˈɛte/
lieti	/ljˈɛti/
lietissimo	/ljetˈissimo/
lieto	/ljˈɛto/
lieve	/ljˈɛve/
lievi	/ljˈɛvi/
li	/ˈli/
lì	/ˈli/
limite	/ˈlimite/
limosina	/limozˈina/
limosine	/limozˈine/
linceo	/lintʃˈɛo/
l'incontravano	/liŋkontrˈavano/
linea	/ˈlinea/
lineamenti	/lineamˈenti/
linee	/ˈlinee/
linguaggio	/liŋɡwˈadʒdʒo/
lingua	/ˈliŋɡwa/
lingue	/ˈliŋɡwe/
lino	/ˈlino/
lipari	/ˈlipari/
liquori	/likwˈori/
lira	/ˈlira/
lisa	/ˈliza/
lisetta	/lizˈetta/
lite	/ˈlite/
litigio	/litˈidʒo/
liti	/ˈliti/
livio	/ˈlivjo/
locati	/lokˈati/
locato	/lokˈato/
lochi	/ˈlɔki/
loco	/ˈlɔko/
loda	/ˈlɔda/
lodando	/lodˈando/
lodare	/lodˈare/
lodata	/lodˈata/
lodati	/lodˈati/
lodato	/lodˈato/
lode	/ˈlɔde/
lodevole	/lodˈevole/
lodevoli	/lodˈevoli/
lodi	/ˈlɔdi/
lodovico	/lodovˈiko/
logica	/ˈlɔdʒika/
lo	/ˈlo/
lombardia	/lombardˈia/
londra	/ˈlondra/
lontana	/lontˈana/
lontananza	/lontanˈantsa/
lontane	/lontˈane/
lontani	/lontˈani/
lontano	/lontˈano/
lorenzo	/lorˈɛntso/
loreta	/lorˈeta/
loro	/ˈloro/
lotta	/ˈlɔtta/
lucano	/lukˈano/
luce	/ˈlutʃe/
lucente	/lutʃˈɛnte/
lucenti	/lutʃˈɛnti/
lucifero	/lutʃˈifero/
luci	/ˈlutʃi/
lucina	/lutʃˈina/
lucio	/ˈlutʃo/
luglio	/ˈluʎʎo/
luigi	/lwˈidʒi/
lui	/ˈlui/
lume	/ˈlume/
lumi	/ˈlumi/
luna	/ˈluna/
lunga	/ˈluŋɡa/
lungamente	/luŋɡamˈente/
lunge	/ˈlundʒe/
lunghe	/ˈluŋɡe/
lunghezza	/luŋɡˈetstsa/
lunghi	/ˈluŋɡi/
lunghissima	/luŋɡˈissima/
lunghissimi	/luŋɡˈissimi/
lungi	/ˈlundʒi/
lungo	/ˈluŋɡo/
luoghi	/lwˈɔɡi/
luogo	/lwˈɔɡo/
lupi	/ˈlupi/
lupo	/ˈlupo/
lusca	/ˈluska/
lusinghe	/luzˈiŋɡe/
lussuria	/lussˈurja/
m'abandoni	/mabandˈoni/
macchia	/ˈmakkja/
macchiare	/makkjˈare/
macchiata	/makkjˈata/
macchiati	/makkjˈati/
macchie	/ˈmakkje/
machiavelli	/makjavˈɛlli/
madama	/madˈama/
maddalena	/maddalˈɛna/
madonna	/madˈɔnna/
madre	/ˈmadre/
madri	/ˈmadri/
maestà	/maestˈa/
maestra	/maˈɛstra/
maestri	/maˈɛstri/
maestro	/maˈɛstro/
maggio	/ˈmadʒdʒo/
maggioranza	/madʒdʒorˈantsa/
maggiore	/madʒdʒˈore/
maggiori	/madʒdʒˈori/
maggiormente	/madʒdʒormˈente/
magna	/ˈmaɲɲa/
magnanimità	/maɲɲanimitˈa/
magnanimo	/maɲɲˈanimo/
magnifica	/maɲɲˈifika/
magnificamente	/maɲɲifikamˈente/
magnificenza	/maɲɲifitʃˈɛntsa/
magnifiche	/maɲɲˈifike/
magnifico	/maɲɲˈifiko/
magno	/ˈmaɲɲo/
magro	/ˈmaɡro/
maia	/ˈmaja/
mai	/ˈmai/
malagevole	/maladʒˈevole/
malagevolmente	/maladʒevolmˈente/
mala	/ˈmala/
malamente	/malamˈente/
male	/ˈmale/
malgrado	/malɡrˈado/
maligna	/malˈiɲɲa/
maligni	/malˈiɲɲi/
malignità	/maliɲɲitˈa/
mali	/ˈmali/
malinconia	/maliŋkonˈia/
malinconico	/maliŋkˈɔniko/
malizia	/malˈitstsja/
malvagia	/malvˈadʒa/
malvagi	/malvˈadʒi/
malvagio	/malvˈadʒo/
malvagità	/malvadʒitˈa/
ma	/ˈma/
mamma	/ˈmamma/
manca	/ˈmaŋka/
mancamento	/maŋkamˈento/
mancando	/maŋkˈando/
mancano	/ˈmaŋkano/
mancante	/maŋkˈante/
mancanza	/maŋkˈantsa/
mancare	/maŋkˈare/
mancarono	/maŋkˈarono/
mancasse	/maŋkˈasse/
mancato	/maŋkˈato/
mancava	/maŋkˈava/
manchi	/ˈmaŋki/
manco	/ˈmaŋko/
mancò	/maŋkˈɔ/
manda	/ˈmanda/
mandando	/mandˈando/
mandano	/ˈmandano/
mandare	/mandˈare/
mandar	/mandˈar/
mandarono	/mandˈarono/
mandasse	/mandˈasse/
mandata	/mandˈata/
mandate	/mandˈate/
mandati	/mandˈati/
mandato	/mandˈato/
mandava	/mandˈava/
manderò	/manderˈɔ/
mandi	/ˈmandi/
mando	/ˈmando/
mandò	/mandˈɔ/
manfredi	/manffrˈedi/
mangia	/ˈmandʒa/
mangiando	/mandʒˈando/
mangiare	/mandʒˈare/
mangiato	/mandʒˈato/
mangiava	/mandʒˈava/
mangiò	/mandʒˈɔ/
maniera	/manjˈɛra/
maniere	/manjˈɛre/
manifesta	/manifˈɛsta/
manifestamente	/manifestamˈente/
manifestare	/manifestˈare/
manifesti	/manifˈɛsti/
manifesto	/manifˈɛsto/
manifestò	/manifestˈɔ/
mani	/ˈmani/
mano	/ˈmano/
mansuetudine	/mansuetˈudine/
mantello	/mantˈɛllo/
mantenne	/mantˈenne/
manto	/ˈmanto/
mantova	/ˈmantova/
mantovano	/mantovˈano/
maraviglia	/maravˈiʎʎa/
maraviglie	/maravˈiʎʎe/
marchese	/markˈeze/
marco	/ˈmarko/
mare	/ˈmare/
maria	/marˈia/
marica	/ˈmarika/
mari	/ˈmari/
marina	/marˈina/
marinari	/marinˈari/
marine	/marˈine/
marini	/marˈini/
marino	/marˈino/
maritata	/maritˈata/
mariti	/marˈiti/
marito	/marˈito/
maritò	/maritˈɔ/
marmi	/ˈmarmi/
marmo	/ˈmarmo/
marmorina	/marmorˈina/
martellino	/martellˈino/
marte	/ˈmarte/
martiri	/martˈiri/
marx	/ˈmarks/
marzo	/ˈmartso/
maschi	/ˈmaski/
maschio	/ˈmaskjo/
masnadieri	/maznadjˈɛri/
maso	/ˈmazo/
massa	/ˈmassa/
massimamente	/massimamˈente/
massime	/ˈmassime/
massimo	/ˈmassimo/
materiale	/materjˈale/
materia	/matˈɛrja/
materie	/matˈɛrje/
matrimoniale	/matrimonjˈale/
matrimoni	/matrimˈɔni/
matrimonio	/matrimˈɔnjo/
matta	/ˈmatta/
mattia	/mattˈia/
mattina	/mattˈina/
matto	/ˈmatto/
matura	/matˈura/
maturi	/matˈuri/
mauritania	/mauritˈanja/
mazziniano	/matstsinjˈano/
mazzini	/matstsˈini/
mazzo	/ˈmatstso/
meco	/ˈmeko/
medesima	/medˈezima/
medesimamente	/medezimamˈente/
medesime	/medˈezime/
medesimi	/medˈezimi/
medesimo	/medˈezimo/
media	/ˈmɛdja/
mediante	/medjˈante/
medicare	/medikˈare/
medici	/ˈmɛditʃi/
medicina	/meditʃˈina/
medicine	/meditʃˈine/
medico	/ˈmɛdiko/
medioevo	/medjoˈɛvo/
medusa	/medˈuza/
megera	/medʒˈɛra/
meglio	/ˈmɛʎʎo/
mei	/ˈmɛi/
mela	/ˈmela/
melano	/ˈmelano/
mele	/ˈmele/
melodia	/melodˈia/
membra	/ˈmɛmbra/
membri	/ˈmɛmbri/
membro	/ˈmɛmbro/
me	/ˈme/
memorabile	/memorˈabile/
memoria	/memˈɔrja/
memorie	/memˈɔrje/
mena	/ˈmena/
menando	/menˈando/
menare	/menˈare/
menarono	/menˈarono/
menasse	/menˈasse/
menata	/menˈata/
menati	/menˈati/
menato	/menˈato/
menava	/menˈava/
meni	/ˈmeni/
menoma	/ˈmɛnoma/
meno	/ˈmeno/
menò	/menˈɔ/
mensa	/ˈmɛnsa/
mense	/ˈmɛnse/
mente	/ˈmente/
menti	/ˈmenti/
mentire	/mentˈire/
mento	/ˈmento/
mentre	/ˈmentre/
menzione	/mentsjˈone/
menzogna	/mentsˈoɲɲa/
menzogne	/mentsˈoɲɲe/
meraviglia	/meravˈiʎʎa/
mercante	/merkˈante/
mercanti	/merkˈanti/
mercatante	/merkatˈante/
mercatanti	/merkatˈanti/
mercato	/merkˈato/
mercede	/mertʃˈede/
mercé	/mertʃˈe/
mercurio	/merkˈurjo/
meretrice	/meretrˈitʃe/
meretrici	/meretrˈitʃi/
meridiano	/meridjˈano/
meritai	/meritˈai/
merita	/ˈmɛrita/
meritamente	/meritamˈente/
meritano	/ˈmɛritano/
meritarono	/meritˈarono/
meritasse	/meritˈasse/
meritata	/meritˈata/
meritato	/meritˈato/
meritevolmente	/meritevolmˈente/
meriti	/ˈmɛriti/
merito	/ˈmɛrito/
meritò	/meritˈɔ/
mescola	/ˈmeskola/
mescolata	/meskolˈata/
mescolate	/meskolˈate/
mescolati	/meskolˈati/
mescolato	/meskolˈato/
mese	/ˈmese/
mesi	/ˈmesi/
messa	/ˈmessa/
messe	/ˈmɛsse/
messere	/messˈɛre/
messi	/ˈmɛssi/
messina	/messˈina/
messo	/ˈmesso/
mestiere	/mestjˈɛre/
mestizia	/mestˈitstsja/
mesto	/ˈmɛsto/
metalli	/metˈalli/
metodo	/ˈmɛtodo/
metta	/ˈmetta/
mette	/ˈmette/
mettendo	/mettˈɛndo/
metterà	/metterˈa/
mettere	/ˈmettere/
mettesse	/mettˈesse/
metteva	/mettˈeva/
metti	/ˈmetti/
metto	/ˈmetto/
mettono	/ˈmettono/
mezzano	/medzdzˈano/
mezzi	/ˈmɛdzdzi/
mezzogiorno	/medzdzodʒˈorno/
mezzo	/ˈmɛdzdzo/
mia	/ˈmia/
mica	/ˈmika/
michele	/mikˈele/
miei	/mjˈɛi/
mie	/ˈmie/
migliaia	/miʎʎˈaja/
miglia	/ˈmiʎʎa/
miglio	/ˈmiʎʎo/
migliore	/miʎʎˈore/
migliori	/miʎʎˈori/
miglior	/miʎʎˈor/
mila	/ˈmila/
milano	/milˈano/
militare	/militˈare/
mille	/ˈmille/
mi	/ˈmi/
minacce	/minˈatʃtʃe/
minaccia	/minˈatʃtʃa/
minacciando	/minatʃtʃˈando/
ministri	/minˈistri/
minore	/minˈore/
minori	/minˈori/
minutamente	/minutamˈente/
minuta	/minˈuta/
minute	/minˈute/
minuti	/minˈuti/
minuto	/minˈuto/
mio	/ˈmio/
mirabile	/mirˈabile/
mirabili	/mirˈabili/
mirabilmente	/mirabilmˈente/
miracoli	/mirˈakoli/
miracolo	/mirˈakolo/
mira	/ˈmira/
mirando	/mirˈando/
mirare	/mirˈare/
miri	/ˈmiri/
mirmidoni	/mirmidˈoni/
mirra	/ˈmirra/
mirto	/ˈmirto/
mise	/ˈmize/
miserabile	/mizerˈabile/
miseramente	/mizeramˈente/
misera	/ˈmizera/
misere	/ˈmizere/
miseria	/mizˈɛrja/
misericordia	/mizerikˈɔrdja/
miserie	/mizˈɛrje/
miseri	/ˈmizeri/
misero	/ˈmizero/
missione	/missjˈone/
misteri	/mistˈɛri/
mistero	/mistˈɛro/
mistieri	/mistjˈɛri/
misura	/mizˈura/
mitigare	/mitiɡˈare/
mobile	/ˈmɔbile/
mobili	/ˈmɔbili/
moderatamente	/moderatamˈente/
moderata	/moderˈata/
moderati	/moderˈati/
moderna	/modˈɛrna/
moderni	/modˈɛrni/
modesto	/modˈɛsto/
modi	/ˈmɔdi/
modo	/ˈmɔdo/
moglie	/ˈmoʎʎe/
mogliere	/moʎʎˈɛre/
mogli	/ˈmoʎʎi/
molestia	/molˈɛstja/
molesto	/molˈɛsto/
molle	/ˈmɔlle/
molli	/ˈmɔlli/
molta	/ˈmolta/
molte	/ˈmolte/
molti	/ˈmolti/
moltitudine	/moltitˈudine/
molto	/ˈmolto/
momenti	/momˈenti/
momento	/momˈento/
monaca	/ˈmɔnaka/
monache	/ˈmɔnake/
monaco	/ˈmɔnako/
monarchia	/monarkˈia/
mondana	/mondˈana/
mondane	/mondˈane/
mondani	/mondˈani/
mondano	/mondˈano/
mondo	/ˈmondo/
moneta	/monˈeta/
monile	/monˈile/
monsignore	/monsiɲɲˈore/
montagna	/montˈaɲɲa/
montagne	/montˈaɲɲe/
monta	/ˈmonta/
montare	/montˈare/
montarono	/montˈarono/
montati	/montˈati/
montato	/montˈato/
monte	/ˈmonte/
monti	/ˈmonti/
montò	/montˈɔ/
morale	/morˈale/
morbide	/ˈmɔrbide/
morbo	/ˈmɔrbo/
morde	/ˈmɔrde/
mordere	/ˈmɔrdere/
morendo	/morˈɛndo/
morganti	/morɡˈanti/
morì	/morˈi/
morire	/morˈire/
morirono	/morˈirono/
morisse	/morˈisse/
morissi	/morˈissi/
moriva	/morˈiva/
morivano	/morˈivano/
mormorare	/mormorˈare/
mormorio	/mormorˈio/
mormorò	/mormorˈɔ/
morsi	/ˈmɔrsi/
morso	/ˈmɔrso/
mortaio	/mortˈajo/
mortale	/mortˈale/
mortali	/mortˈali/
mortalità	/mortalitˈa/
mortal	/mortˈal/
morta	/ˈmɔrta/
morte	/ˈmɔrte/
morti	/ˈmɔrti/
morto	/ˈmɔrto/
mosè	/mozˈɛ/
mossa	/ˈmɔssa/
mosse	/ˈmɔsse/
mossero	/ˈmɔssero/
mossi	/ˈmɔssi/
mosso	/ˈmɔsso/
mostra	/ˈmostra/
mostrando	/mostrˈando/
mostrano	/ˈmostrano/
mostrare	/mostrˈare/
mostrarono	/mostrˈarono/
mostrasse	/mostrˈasse/
mostrata	/mostrˈata/
mostrate	/mostrˈate/
mostrati	/mostrˈati/
mostrato	/mostrˈato/
mostrava	/mostrˈava/
mostravano	/mostrˈavano/
mostrerà	/mostrerˈa/
mostrerò	/mostrerˈɔ/
mostri	/ˈmostri/
mostro	/ˈmostro/
mostrò	/mostrˈɔ/
moti	/ˈmɔti/
motivo	/motˈivo/
moto	/ˈmɔto/
motteggiando	/mottedʒdʒˈando/
motteggiare	/mottedʒdʒˈare/
motti	/ˈmɔtti/
motto	/ˈmɔtto/
move	/ˈmɔve/
movendo	/movˈɛndo/
movesse	/movˈesse/
moveva	/movˈeva/
movimenti	/movimˈenti/
movimento	/movimˈento/
multa	/ˈmulta/
municipio	/munitʃˈipjo/
muova	/mwˈɔva/
muove	/mwˈɔve/
muovere	/mwˈɔvere/
muovono	/mwˈɔvono/
mura	/ˈmura/
muri	/ˈmuri/
muro	/ˈmuro/
museo	/muzˈɛo/
musica	/ˈmuzika/
mutamenti	/mutamˈenti/
mutamento	/mutamˈento/
muta	/ˈmuta/
mutano	/ˈmutano/
mutare	/mutˈare/
mutasse	/mutˈasse/
mutata	/mutˈata/
mutato	/mutˈato/
muti	/ˈmuti/
mutolo	/ˈmutolo/
mutò	/mutˈɔ/
nacque	/ˈnakkwe/
nacquero	/ˈnakkwero/
nacqui	/ˈnakkwi/
napoli	/ˈnapoli/
narciso	/nartʃˈizo/
nardin	/nardˈin/
narra	/ˈnarra/
narrando	/narrˈando/
narrano	/ˈnarrano/
narrare	/narrˈare/
narrata	/narrˈata/
narrate	/narrˈate/
narrato	/narrˈato/
narrava	/narrˈava/
narrerò	/narrerˈɔ/
narrò	/narrˈɔ/
nasca	/ˈnaska/
nascano	/ˈnaskano/
nasce	/ˈnaʃʃe/
nascendo	/naʃʃˈɛndo/
nascere	/ˈnaʃʃere/
nascesse	/naʃʃˈesse/
nascessero	/naʃʃˈessero/
nasceva	/naʃʃˈeva/
nascevano	/naʃʃˈevano/
nasconda	/naskˈonda/
nasconde	/naskˈonde/
nascondere	/naskˈondere/
nascono	/ˈnaskono/
nascosa	/naskˈosa/
nascose	/naskˈose/
nascosi	/naskˈosi/
nascoso	/naskˈoso/
nascosta	/naskˈosta/
nascoste	/naskˈoste/
nascosti	/naskˈosti/
nascosto	/naskˈosto/
naso	/ˈnaso/
natale	/natˈale/
nata	/ˈnata/
nate	/ˈnate/
nati	/ˈnati/
natività	/nativitˈa/
nato	/ˈnato/
naturale	/naturˈale/
naturali	/naturˈali/
naturalmente	/naturalmˈente/
natura	/natˈura/
nature	/natˈure/
naufragio	/naufrˈadʒo/
nave	/ˈnave/
n'avessero	/navˈessero/
navicella	/navitʃˈɛlla/
navi	/ˈnavi/
nazionale	/natstsjonˈale/
nazione	/natstsjˈone/
nazioni	/natstsjˈoni/
necessariamente	/netʃessarjamˈente/
necessaria	/netʃessˈarja/
necessarie	/netʃessˈarje/
necessario	/netʃessˈarjo/
necessità	/netʃessitˈa/
negano	/ˈneɡano/
negare	/neɡˈare/
negata	/neɡˈata/
negato	/neɡˈato/
negherò	/neɡerˈɔ/
negli	/ˈneʎʎi/
nego	/ˈneɡo/
negro	/ˈneɡro/
nei	/ˈnɛi/
nell'abito	/nellˈabito/
nella	/ˈnɛlla/
nelle	/ˈnelle/
nelli	/ˈnelli/
nello	/ˈnɛllo/
nel	/ˈnel/
nemica	/nemˈika/
nemici	/nemˈitʃi/
nemico	/nemˈiko/
ne	/ne/
né	/ˈne/
neoguelfa	/neoɡwˈɛlfa/
neoguelfo	/neoɡwˈɛlfo/
neppure	/neppˈure/
nequizia	/nekwˈitstsja/
nera	/ˈnera/
nere	/ˈnere/
nereo	/ˈnereo/
neri	/ˈneri/
nero	/ˈnero/
nervi	/ˈnɛrvi/
nesso	/ˈnɛsso/
nessuna	/nessˈuna/
nessuno	/nessˈuno/
nestore	/ˈnɛstore/
netto	/ˈnetto/
nettuno	/nettˈuno/
neve	/ˈneve/
nevi	/ˈnevi/
nido	/ˈnido/
niente	/njˈɛnte/
nilo	/ˈnilo/
nimica	/nimˈika/
nimici	/nimˈitʃi/
nimico	/nimˈiko/
ninfa	/ˈninffa/
ninfe	/ˈninffe/
nipote	/nipˈote/
nisi	/ˈnizi/
niuna	/njˈuna/
niuno	/njˈuno/
nobile	/ˈnɔbile/
nobili	/ˈnɔbili/
nobilissima	/nobilˈissima/
nobilissime	/nobilˈissime/
nobilissimi	/nobilˈissimi/
nobilissimo	/nobilˈissimo/
nobilmente	/nobilmˈente/
nobiltà	/nobiltˈa/
nocchieri	/nokkjˈɛri/
nocchiero	/nokkjˈɛro/
nocenti	/notʃˈɛnti/
nodo	/ˈnɔdo/
noia	/ˈnɔja/
noie	/ˈnɔje/
noi	/ˈnoi/
noiosa	/nojˈosa/
noiose	/nojˈose/
noiosi	/nojˈosi/
noioso	/nojˈoso/
noma	/ˈnɔma/
nomata	/nomˈata/
nomati	/nomˈati/
nomato	/nomˈato/
nome	/ˈnome/
nominare	/nominˈare/
nominata	/nominˈata/
nominato	/nominˈato/
nomi	/ˈnɔmi/
nomò	/nomˈɔ/
nona	/ˈnɔna/
nondimeno	/nondimˈeno/
nonna	/ˈnɔnna/
non	/ˈnɔn/
nono	/ˈnɔno/
nostra	/ˈnɔstra/
nostre	/ˈnɔstre/
nostri	/ˈnɔstri/
nostro	/ˈnɔstro/
notabile	/notˈabile/
notabili	/notˈabili/
nota	/ˈnɔta/
notare	/notˈare/
note	/ˈnɔte/
notizia	/notˈitstsja/
noto	/ˈnɔto/
notte	/ˈnɔtte/
notti	/ˈnɔtti/
notturni	/nottˈurni/
nova	/ˈnɔva/
novellamente	/novellamˈente/
novella	/novˈɛlla/
novelle	/novˈɛlle/
novelli	/novˈɛlli/
novello	/novˈɛllo/
nove	/ˈnɔve/
novità	/novitˈa/
novo	/ˈnɔvo/
nozze	/ˈnɔtstse/
nube	/ˈnube/
nubi	/ˈnubi/
nulla	/ˈnulla/
nullo	/ˈnullo/
numeri	/ˈnumeri/
numero	/ˈnumero/
numerosi	/numerˈosi/
nuoce	/nwˈɔtʃe/
nuocere	/nwˈɔtʃere/
nuovamente	/nwovamˈente/
nuova	/nwˈɔva/
nuove	/nwˈɔve/
nuovi	/nwˈɔvi/
nuovo	/nwˈɔvo/
nutrice	/nutrˈitʃe/
nuvola	/ˈnuvola/
nuvoli	/ˈnuvoli/
obbedendo	/obbedˈɛndo/
obbietti	/obbjˈɛtti/
obbietto	/obbjˈɛtto/
oblio	/oblˈio/
occasione	/okkazjˈone/
occhi	/ˈɔkki/
occhio	/ˈɔkkjo/
occidentale	/otʃtʃidentˈale/
occidentali	/otʃtʃidentˈali/
occidente	/otʃtʃidˈɛnte/
occorre	/okkˈorre/
occorse	/okkˈorse/
occultamente	/okkultamˈente/
occulta	/okkˈulta/
occulte	/okkˈulte/
occulti	/okkˈulti/
occulto	/okkˈulto/
occupa	/ˈɔkkupa/
occupare	/okkupˈare/
occupata	/okkupˈata/
occupati	/okkupˈati/
occupato	/okkupˈato/
occupò	/okkupˈɔ/
oceano	/otʃˈɛano/
oda	/ˈɔda/
ode	/ˈɔde/
odi	/ˈɔdi/
odio	/ˈɔdjo/
od	/ˈod/
odo	/ˈɔdo/
odore	/odˈore/
offendere	/offˈɛndere/
offerse	/offˈɛrse/
offerto	/offˈɛrto/
offesa	/offˈesa/
offese	/offˈese/
offesi	/offˈesi/
offeso	/offˈeso/
oggimai	/odʒdʒimˈai/
oggi	/ˈɔdʒdʒi/
ogni	/ˈoɲɲi/
ogniuno	/oɲɲiˈuno/
ognora	/oɲɲˈora/
ohimè	/oimˈɛ/
oh	/ˈɔ/
oimè	/oimˈɛ/
oltraggio	/oltrˈadʒdʒo/
oltre	/ˈoltre/
omai	/omˈai/
ombra	/ˈombra/
ombre	/ˈombre/
omeri	/ˈɔmeri/
omero	/ˈɔmero/
onde	/ˈonde/
onestamente	/onestamˈente/
onesta	/onˈɛsta/
onestà	/onestˈa/
oneste	/onˈɛste/
onesti	/onˈɛsti/
onestissima	/onestˈissima/
onesto	/onˈɛsto/
onnipotente	/onnipotˈɛnte/
onorare	/onorˈare/
onoratamente	/onoratamˈente/
onorata	/onorˈata/
onorati	/onorˈati/
onorato	/onorˈato/
onore	/onˈore/
onorevole	/onorˈevole/
onorevolmente	/onorevolmˈente/
onori	/onˈori/
onta	/ˈonta/
operando	/operˈando/
opera	/ˈɔpera/
operare	/operˈare/
operasse	/operˈasse/
operata	/operˈata/
operato	/operˈato/
operazione	/operatstsjˈone/
operazioni	/operatstsjˈoni/
opere	/ˈɔpere/
opinione	/opinjˈone/
opinioni	/opinjˈoni/
opporre	/oppˈorre/
opportuna	/opportˈuna/
opportune	/opportˈune/
opportuno	/opportˈuno/
opposte	/oppˈoste/
oppressa	/opprˈɛssa/
oprando	/oprˈando/
oprano	/ˈɔprano/
opra	/ˈɔpra/
oprare	/oprˈare/
oprate	/oprˈate/
oprato	/oprˈato/
oprò	/oprˈɔ/
oracoli	/orˈakoli/
oracolo	/orˈakolo/
oramai	/oramˈai/
ora	/ˈɔra/
orazione	/oratstsjˈone/
orazioni	/oratstsjˈoni/
orco	/ˈɔrko/
ordinare	/ordinˈare/
ordinarono	/ordinˈarono/
ordinasse	/ordinˈasse/
ordinatamente	/ordinatamˈente/
ordinata	/ordinˈata/
ordinate	/ordinˈate/
ordinati	/ordinˈati/
ordinato	/ordinˈato/
ordine	/ˈordine/
ordini	/ˈordini/
ordinò	/ordinˈɔ/
orecchie	/orˈekkje/
orecchi	/orˈekki/
oreste	/orˈɛste/
oretta	/orˈetta/
orfeo	/orfˈɛo/
orgoglio	/orɡˈoʎʎo/
orientale	/orjentˈale/
orientali	/orjentˈali/
oriente	/orjˈɛnte/
origine	/orˈidʒine/
ormai	/ormˈai/
ornamenti	/ornamˈenti/
ornamento	/ornamˈento/
ornare	/ornˈare/
ornata	/ornˈata/
ornate	/ornˈate/
ornati	/ornˈati/
ornato	/ornˈato/
or	/ˈor/
oro	/ˈɔro/
orrevole	/orrˈevole/
orso	/ˈorso/
oscura	/oskˈura/
oscure	/oskˈure/
oscuri	/oskˈuri/
oscurità	/oskuritˈa/
oscuro	/oskˈuro/
ossa	/ˈɔssa/
osservare	/osservˈare/
osservato	/osservˈato/
ostante	/ostˈante/
oste	/ˈɔste/
ostinatamente	/ostinatamˈente/
ostinata	/ostinˈata/
ostinato	/ostinˈato/
ottava	/ottˈava/
ottaviano	/ottavjˈano/
ottavo	/ottˈavo/
ottenere	/ottenˈere/
ottenne	/ottˈenne/
ottimamente	/ottimamˈente/
ottima	/ˈɔttima/
ottimi	/ˈɔttimi/
ottimo	/ˈɔttimo/
otto	/ˈɔtto/
ove	/ˈove/
over	/ˈover/
ovidio	/ovˈidjo/
ovunque	/ovˈuŋkwe/
ovvero	/ovvˈero/
ozio	/ˈɔtstsjo/
pace	/ˈpatʃe/
padiglioni	/padiʎʎˈoni/
padova	/ˈpadova/
padre	/ˈpadre/
padri	/ˈpadri/
padrona	/padrˈona/
padrone	/padrˈone/
padroni	/padrˈoni/
paesani	/paezˈani/
paese	/paˈeze/
paesi	/paˈezi/
paganelli	/paɡanˈɛlli/
pagare	/paɡˈare/
pagato	/paɡˈato/
pagina	/ˈpadʒina/
pagine	/ˈpadʒine/
paglia	/ˈpaʎʎa/
paiano	/ˈpajano/
paia	/ˈpaja/
paiono	/ˈpajono/
paio	/ˈpajo/
palazzi	/palˈatstsi/
palazzo	/palˈatstso/
palco	/ˈpalko/
palermo	/palˈɛrmo/
palesare	/palezˈare/
palese	/palˈeze/
palesi	/palˈezi/
pallida	/ˈpallida/
pallide	/ˈpallide/
pallidezza	/pallidˈetstsa/
pallido	/ˈpallido/
palma	/ˈpalma/
palme	/ˈpalme/
palo	/ˈpalo/
palude	/palˈude/
paludi	/palˈudi/
pane	/ˈpane/
panfilo	/ˈpanffilo/
pani	/ˈpani/
panni	/ˈpanni/
panno	/ˈpanno/
paolo	/ˈpaolo/
paone	/paˈone/
papa	/ˈpapa/
paradiso	/paradˈizo/
parche	/ˈparke/
parecchie	/parˈekkje/
parecchi	/parˈekki/
parentado	/parentˈado/
parente	/parˈɛnte/
parenti	/parˈɛnti/
pare	/ˈpare/
parere	/parˈere/
paresse	/parˈesse/
paressero	/parˈessero/
parete	/parˈete/
pareti	/parˈeti/
parevano	/parˈevano/
pareva	/parˈeva/
parigi	/parˈidʒi/
parimente	/parimˈente/
pari	/ˈpari/
paris	/ˈparis/
parlamenti	/parlamˈenti/
parlamento	/parlamˈento/
parlando	/parlˈando/
parlano	/ˈparlano/
parlante	/parlˈante/
parla	/ˈparla/
parlare	/parlˈare/
parlari	/parlˈari/
parlarono	/parlˈarono/
parlar	/parlˈar/
parlasse	/parlˈasse/
parlato	/parlˈato/
parlava	/parlˈava/
parlerò	/parlerˈɔ/
parliamo	/parljˈamo/
parli	/ˈparli/
parlo	/ˈparlo/
parlò	/parlˈɔ/
parnaso	/parnˈazo/
parola	/parˈɔla/
parole	/parˈɔle/
parrà	/parrˈa/
parrebbe	/parrˈɛbbe/
parso	/ˈparso/
parta	/ˈparta/
partendo	/partˈɛndo/
partenza	/partˈɛntsa/
parte	/ˈparte/
particella	/partitʃˈɛlla/
particelle	/partitʃˈɛlle/
particolare	/partikolˈare/
particolari	/partikolˈari/
particolarmente	/partikolarmˈente/
partii	/partˈii/
partimmo	/partˈimmo/
parti	/ˈparti/
partì	/partˈi/
partirai	/partirˈai/
partirà	/partirˈa/
partire	/partˈire/
partirono	/partˈirono/
partirò	/partirˈɔ/
partisce	/partˈiʃʃe/
partisse	/partˈisse/
partissi	/partˈissi/
partitamente	/partitamˈente/
partita	/partˈita/
partite	/partˈite/
partiti	/partˈiti/
partito	/partˈito/
partiva	/partˈiva/
parto	/ˈparto/
partorendo	/partorˈɛndo/
partorì	/partorˈi/
partorire	/partorˈire/
partorisce	/partorˈiʃʃe/
partoriscono	/partorˈiskono/
partorisse	/partorˈisse/
partoriti	/partorˈiti/
partorito	/partorˈito/
paruta	/parˈuta/
paruto	/parˈuto/
parve	/ˈparve/
parvero	/ˈparvero/
pascendo	/paʃʃˈɛndo/
pasce	/ˈpaʃʃe/
pascere	/ˈpaʃʃere/
pascono	/ˈpaskono/
pasquino	/paskwˈino/
passaggio	/passˈadʒdʒo/
passando	/passˈando/
passano	/ˈpassano/
passa	/ˈpassa/
passare	/passˈare/
passarono	/passˈarono/
passasse	/passˈasse/
passata	/passˈata/
passate	/passˈate/
passati	/passˈati/
passato	/passˈato/
passavano	/passˈavano/
passava	/passˈava/
passerà	/passerˈa/
passiamo	/passjˈamo/
passione	/passjˈone/
passioni	/passjˈoni/
passi	/ˈpassi/
passo	/ˈpasso/
passò	/passˈɔ/
pastore	/pastˈore/
pastori	/pastˈori/
pastura	/pastˈura/
paterna	/patˈɛrna/
paterno	/patˈɛrno/
paternostri	/paternˈɔstri/
pater	/ˈpater/
patire	/patˈire/
patisce	/patˈiʃʃe/
patito	/patˈito/
patria	/ˈpatrja/
patrimonio	/patrimˈɔnjo/
patti	/ˈpatti/
patto	/ˈpatto/
paura	/paˈura/
paure	/paˈure/
paurosa	/paurˈosa/
paurose	/paurˈose/
paurosi	/paurˈosi/
pauroso	/paurˈoso/
pausa	/ˈpauza/
pavia	/pavˈia/
pazientemente	/patstsjentemˈente/
paziente	/patstsjˈɛnte/
pazienza	/patstsjˈɛntsa/
pazzamente	/patstsamˈente/
pazza	/ˈpatstsa/
pazzia	/patstsˈia/
pazzie	/patstsˈie/
pazzi	/ˈpatstsi/
pazzo	/ˈpatstso/
peccare	/pekkˈare/
peccati	/pekkˈati/
peccato	/pekkˈato/
pecora	/ˈpɛkora/
pecore	/ˈpɛkore/
pedale	/pedˈale/
peggio	/ˈpɛdʒdʒo/
peggiore	/pedʒdʒˈore/
pegno	/ˈpeɲɲo/
pellegrinaggio	/pelleɡrinˈadʒdʒo/
pellegrino	/pelleɡrˈino/
pelle	/ˈpɛlle/
pelli	/ˈpɛlli/
pelo	/ˈpelo/
pel	/ˈpel/
peltro	/ˈpeltro/
pena	/ˈpena/
pendente	/pendˈɛnte/
pende	/ˈpɛnde/
pene	/ˈpɛne/
penetrare	/penetrˈare/
penitenza	/penitˈɛntsa/
penna	/ˈpenna/
penne	/ˈpenne/
penosa	/penˈosa/
penoso	/penˈoso/
pensai	/pensˈai/
pensando	/pensˈando/
pensano	/ˈpɛnsano/
pensa	/ˈpɛnsa/
pensare	/pensˈare/
pensata	/pensˈata/
pensate	/pensˈate/
pensato	/pensˈato/
pensatore	/pensatˈore/
pensava	/pensˈava/
pensiamo	/pensjˈamo/
pensieri	/pensjˈɛri/
pensiero	/pensjˈɛro/
pensi	/ˈpɛnsi/
penso	/ˈpɛnso/
pensò	/pensˈɔ/
pensoso	/pensˈoso/
penultima	/penˈultima/
peranco	/perˈaŋko/
perche	/ˈpɛrke/
perché	/perkˈe/
percossa	/perkˈɔssa/
percosse	/perkˈɔsse/
percosso	/perkˈɔsso/
percuotere	/perkwˈɔtere/
perdei	/perdˈei/
perdendo	/perdˈɛndo/
perde	/ˈpɛrde/
perdere	/ˈpɛrdere/
perdita	/ˈpɛrdita/
perdizione	/perditstsjˈone/
perdona	/perdˈona/
perdonare	/perdonˈare/
perdonato	/perdonˈato/
perdoni	/perdˈoni/
perdono	/perdˈono/
perdonò	/perdonˈɔ/
perduta	/perdˈuta/
perdute	/perdˈute/
perduti	/perdˈuti/
perduto	/perdˈuto/
peregrina	/pereɡrˈina/
peregrino	/pereɡrˈino/
perfettamente	/perfettamˈente/
perfetta	/perfˈɛtta/
perfetto	/perfˈɛtto/
perfezione	/perfetstsjˈone/
perfino	/perfˈino/
pericoli	/perˈikoli/
pericolo	/perˈikolo/
pericolosi	/perikolˈosi/
pericoloso	/perikolˈoso/
periodo	/perˈiodo/
perire	/perˈire/
perisca	/perˈiska/
perle	/ˈpɛrle/
pero	/ˈpero/
però	/perˈɔ/
per	/ˈper/
perpetua	/perpˈɛtua/
perpetuo	/perpˈɛtuo/
persa	/ˈpɛrsa/
perseverando	/perseverˈando/
perseveranza	/perseverˈantsa/
persi	/ˈpɛrsi/
persona	/persˈona/
persone	/persˈone/
persuadere	/persuadˈere/
persuase	/persuˈaze/
persuasione	/persuazjˈone/
persuasioni	/persuazjˈoni/
pertanto	/pertˈanto/
pertugio	/pertˈudʒo/
perturbazioni	/perturbatstsjˈoni/
perugia	/perˈudʒa/
pervengono	/pervˈɛŋɡono/
pervenire	/pervenˈire/
pervenisse	/pervenˈisse/
pervenne	/pervˈenne/
pervennero	/pervˈennero/
pervenni	/pervˈenni/
pervenuta	/pervenˈuta/
pervenuti	/pervenˈuti/
pervenuto	/pervenˈuto/
perviene	/perviˈɛne/
pesce	/ˈpeʃʃe/
pesci	/ˈpeʃʃi/
pesi	/ˈpesi/
peso	/ˈpeso/
pessimo	/ˈpɛssimo/
peste	/ˈpɛste/
pestilenza	/pestilˈɛntsa/
petti	/ˈpɛtti/
petto	/ˈpɛtto/
pezza	/ˈpɛtstsa/
pezzi	/ˈpɛtstsi/
pezzo	/ˈpɛtstso/
piaccia	/pjˈatʃtʃa/
piacciono	/pjˈatʃtʃono/
piacendo	/pjatʃˈɛndo/
piace	/pjˈatʃe/
piacerà	/pjatʃerˈa/
piacere	/pjatʃˈere/
piaceri	/pjatʃˈeri/
piacesse	/pjatʃˈesse/
piaceva	/pjatʃˈeva/
piacevole	/pjatʃˈevole/
piacevolezza	/pjatʃevolˈetstsa/
piacevoli	/pjatʃˈevoli/
piacevolmente	/pjatʃevolmˈente/
piaciuta	/pjatʃˈuta/
piaciuto	/pjatʃˈuto/
piacque	/pjˈakkwe/
piacquero	/pjˈakkwero/
piaga	/pjˈaɡa/
piaghe	/pjˈaɡe/
pianamente	/pjanamˈente/
pianeta	/pjanˈeta/
pianeti	/pjanˈeti/
piangendo	/pjandʒˈɛndo/
piange	/pjˈandʒe/
piangere	/pjˈandʒere/
piano	/pjˈano/
pianse	/pjˈanse/
pianta	/pjˈanta/
piante	/pjˈante/
pianti	/pjˈanti/
pianto	/pjˈanto/
pianura	/pjanˈura/
pia	/ˈpia/
piazza	/pjˈatstsa/
piazze	/pjˈatstse/
picciola	/ˈpitʃtʃola/
picciole	/ˈpitʃtʃole/
piccioli	/pitʃtʃˈɔli/
picciolo	/pitʃtʃˈɔlo/
piccola	/ˈpikkola/
piccole	/ˈpikkole/
piccoli	/ˈpikkoli/
piccolo	/ˈpikkolo/
piede	/pjˈɛde/
piedi	/pjˈɛdi/
piegare	/pjeɡˈare/
piegato	/pjeɡˈato/
pienamente	/pjenamˈente/
piena	/pjˈɛna/
piene	/pjˈɛne/
pienezza	/pjenˈetstsa/
pieni	/pjˈɛni/
pieno	/pjˈɛno/
piè	/pjˈɛ/
piero	/pjˈɛro/
pietosamente	/pjetosamˈente/
pietosa	/pjetˈosa/
pietose	/pjetˈose/
pietosi	/pjetˈosi/
pietoso	/pjetˈoso/
pietra	/pjˈɛtra/
pietre	/pjˈɛtre/
pietro	/pjˈetro/
pigliando	/piʎʎˈando/
pigliano	/ˈpiʎʎano/
piglia	/ˈpiʎʎa/
pigliare	/piʎʎˈare/
pigliarono	/piʎʎˈarono/
pigliasse	/piʎʎˈasse/
pigliata	/piʎʎˈata/
pigliate	/piʎʎˈate/
pigliato	/piʎʎˈato/
piglio	/ˈpiʎʎo/
pigliò	/piʎʎˈɔ/
pigli	/ˈpiʎʎi/
pigri	/ˈpiɡri/
pigro	/ˈpiɡro/
pilade	/ˈpilade/
pilato	/pilˈato/
pino	/ˈpino/
pioggia	/pjˈɔdʒdʒa/
piombo	/pjˈombo/
pio	/ˈpio/
piro	/ˈpiro/
pisa	/ˈpisa/
pistoia	/pistˈɔja/
piume	/pjˈume/
più	/piˈu/
piuttosto	/pjuttˈɔsto/
plebe	/plˈɛbe/
plebi	/plˈɛbi/
pleiadi	/plˈɛjadi/
plinio	/plˈinjo/
plutone	/plutˈone/
poca	/ˈpɔka/
poche	/ˈpɔke/
pochi	/ˈpɔki/
poco	/ˈpɔko/
podestà	/podestˈa/
poema	/poˈɛma/
poemi	/poˈɛmi/
poesia	/poezˈia/
poeta	/poˈɛta/
poetica	/poˈɛtika/
poetiche	/poˈɛtike/
poetici	/poˈɛtitʃi/
poetico	/poˈɛtiko/
poeti	/poˈɛti/
poggio	/ˈpɔdʒdʒo/
poiché	/poikˈe/
poi	/ˈpɔi/
politica	/polˈitika/
politici	/polˈititʃi/
politico	/polˈitiko/
polo	/ˈpɔlo/
polso	/ˈpolso/
polvere	/ˈpolvere/
polverosi	/polverˈosi/
pomeriggio	/pomerˈidʒdʒo/
pomi	/ˈpomi/
pomo	/ˈpomo/
pompeo	/pompˈɛo/
ponendo	/ponˈɛndo/
ponente	/ponˈɛnte/
pone	/ˈpone/
ponesse	/ponˈesse/
poneva	/ponˈeva/
ponga	/ˈpoŋɡa/
pongono	/ˈpoŋɡono/
pongo	/ˈpoŋɡo/
poni	/ˈponi/
ponno	/ˈpɔnno/
pontefice	/pontˈefitʃe/
pontefici	/pontˈefitʃi/
ponte	/ˈponte/
po	/ˈpo/
popolare	/popolˈare/
popoli	/ˈpɔpoli/
popolo	/ˈpɔpolo/
pò	/ˈpɔ/
poppa	/ˈpoppa/
porci	/ˈpɔrtʃi/
porco	/ˈpɔrko/
porgendo	/pordʒˈɛndo/
porge	/ˈpɔrdʒe/
porgere	/ˈpɔrdʒere/
porgesse	/pordʒˈesse/
porgete	/pordʒˈete/
porgeva	/pordʒˈeva/
porgi	/ˈpɔrdʒi/
porgono	/ˈpɔrɡono/
poria	/porˈia/
porre	/ˈporre/
porrò	/porrˈɔ/
porse	/ˈpɔrse/
porsero	/ˈpɔrsero/
porsi	/ˈpɔrsi/
portando	/portˈando/
portano	/ˈpɔrtano/
portante	/portˈante/
porta	/ˈpɔrta/
portare	/portˈare/
portarono	/portˈarono/
portasse	/portˈasse/
portassero	/portˈassero/
portasti	/portˈasti/
portata	/portˈata/
portate	/portˈate/
portati	/portˈati/
portato	/portˈato/
portavano	/portˈavano/
portava	/portˈava/
porte	/ˈpɔrte/
portino	/ˈpɔrtino/
porti	/ˈpɔrti/
porto	/ˈpɔrto/
portò	/portˈɔ/
posa	/ˈpɔsa/
poscia	/ˈpɔʃʃa/
pose	/ˈpɔse/
posero	/ˈposero/
posizione	/pozitstsjˈone/
possano	/ˈpɔssano/
possa	/ˈpɔssa/
possedere	/possedˈere/
possedesse	/possedˈesse/
possedette	/possedˈɛtte/
possente	/possˈɛnte/
possenti	/possˈɛnti/
possessione	/possessjˈone/
possessioni	/possessjˈoni/
possiamo	/possjˈamo/
possiate	/possiˈate/
possibile	/possˈibile/
possibili	/possˈibili/
possibilità	/possibilitˈa/
possiede	/possjˈɛde/
possi	/ˈpɔssi/
possono	/ˈpɔssono/
posso	/ˈpɔsso/
posta	/ˈposta/
poste	/ˈposte/
posteri	/ˈpɔsteri/
posterità	/posteritˈa/
posti	/ˈposti/
posto	/ˈposto/
potei	/potˈei/
potendo	/potˈɛndo/
potente	/potˈɛnte/
potenti	/potˈɛnti/
potentissimo	/potentˈissimo/
potenza	/potˈɛntsa/
potenze	/potˈɛntse/
potenzia	/potˈɛntsja/
poté	/potˈe/
potere	/potˈere/
poterono	/potˈerono/
potesse	/potˈesse/
potessero	/potˈessero/
potessi	/potˈessi/
poteste	/potˈeste/
potete	/potˈete/
potevano	/potˈevano/
poteva	/potˈeva/
potevi	/potˈevi/
potrai	/potrˈai/
potranno	/potrˈanno/
potrà	/potrˈa/
potrebbe	/potrˈɛbbe/
potrei	/potrˈɛi/
potremmo	/potrˈemmo/
potremo	/potrˈemo/
potreste	/potrˈeste/
potresti	/potrˈesti/
potrete	/potrˈete/
potrò	/potrˈɔ/
potuta	/potˈuta/
potuti	/potˈuti/
potuto	/potˈuto/
poveramente	/poveramˈente/
povera	/ˈpɔvera/
povere	/ˈpɔvere/
poveretta	/poverˈetta/
poveri	/ˈpɔveri/
poverissimo	/poverˈissimo/
povero	/ˈpɔvero/
povertà	/povertˈa/
pozzo	/ˈpotstso/
pranzo	/prˈandzo/
prati	/prˈati/
prato	/prˈato/
precedente	/pretʃedˈɛnte/
precedenti	/pretʃedˈɛnti/
precettore	/pretʃettˈore/
preda	/prˈɛda/
predecessori	/predetʃessˈori/
predetta	/predˈetta/
predette	/predˈette/
predetti	/predˈetti/
predetto	/predˈetto/
predisse	/predˈisse/
pregai	/preɡˈai/
pregando	/preɡˈando/
pregare	/preɡˈare/
pregarono	/preɡˈarono/
pregato	/preɡˈato/
pregava	/preɡˈava/
preghiamo	/preɡjˈamo/
preghiera	/preɡjˈɛra/
preghiere	/preɡjˈɛre/
preghi	/prˈɛɡi/
pregio	/prˈɛdʒo/
pregna	/prˈeɲɲa/
prego	/prˈɛɡo/
pregò	/preɡˈɔ/
preme	/prˈɛme/
premessa	/premˈessa/
premesse	/premˈesse/
preminenza	/preminˈɛntsa/
premio	/prˈɛmjo/
prencipe	/prˈɛntʃipe/
prencipi	/prˈɛntʃipi/
prenda	/prˈɛnda/
prendendo	/prendˈɛndo/
prende	/prˈɛnde/
prendere	/prˈɛndere/
prenderò	/prenderˈɔ/
prendesse	/prendˈesse/
prendete	/prendˈete/
prendeva	/prendˈeva/
prendiamo	/prendjˈamo/
prendi	/prˈɛndi/
prendono	/prˈɛndono/
prendo	/prˈɛndo/
preparato	/preparˈato/
presa	/prˈesa/
presenta	/prezˈɛnta/
presentare	/prezentˈare/
presentava	/prezentˈava/
presente	/prezˈɛnte/
presentimenti	/presentimˈenti/
presentimento	/presentimˈento/
presenti	/prezˈɛnti/
presentò	/prezentˈɔ/
presenza	/prezˈɛntsa/
presenzia	/prezˈɛntsja/
prese	/prˈese/
presero	/prˈesero/
presi	/prˈesi/
preso	/prˈeso/
presso	/prˈɛsso/
prestamente	/prestamˈente/
presta	/prˈɛsta/
prestare	/prestˈare/
prestasse	/prestˈasse/
prestato	/prestˈato/
presti	/prˈɛsti/
presto	/prˈɛsto/
prestò	/prestˈɔ/
presumere	/prezˈumere/
presunzione	/prezuntsjˈone/
prete	/prˈɛte/
preterito	/pretˈɛrito/
preti	/prˈɛti/
previsioni	/previzjˈoni/
preziose	/pretstsjˈose/
preziosi	/pretstsjˈosi/
prezioso	/pretstsjˈoso/
prezzo	/prˈɛtstso/
prima	/prˈima/
primavera	/primavˈɛra/
prime	/prˈime/
primieramente	/primjeramˈente/
primiera	/primjˈɛra/
primiere	/primjˈɛre/
primieri	/primjˈɛri/
primiero	/primjˈɛro/
primi	/prˈimi/
primo	/prˈimo/
principale	/printʃipˈale/
principali	/printʃipˈali/
principalmente	/printʃipalmˈente/
principato	/printʃipˈato/
principe	/prˈintʃipe/
principii	/printʃˈipji/
principio	/printʃˈipjo/
principi	/printʃˈipi/
prisco	/prˈisko/
priva	/prˈiva/
privatamente	/privatamˈente/
privata	/privˈata/
privati	/privˈati/
privato	/privˈato/
privilegio	/privilˈɛdʒo/
privi	/prˈivi/
privo	/prˈivo/
problema	/problˈɛma/
procacciando	/prokatʃtʃˈando/
procacciano	/prokˈatʃtʃano/
procaccia	/prokˈatʃtʃa/
procacciare	/prokatʃtʃˈare/
proceda	/protʃˈɛda/
procedendo	/protʃedˈɛndo/
procede	/protʃˈɛde/
procedere	/protʃˈɛdere/
procedesse	/protʃedˈesse/
procedette	/protʃedˈɛtte/
procedono	/protʃˈɛdono/
processione	/protʃessjˈone/
processo	/protʃˈɛsso/
proda	/prˈɔda/
prodotta	/prodˈotta/
prodotte	/prodˈotte/
prodotti	/prodˈotti/
prodotto	/prodˈotto/
produce	/prodˈutʃe/
produrre	/prodˈurre/
produsse	/prodˈusse/
professore	/professˈore/
profeta	/profˈɛta/
profeti	/profˈɛti/
profitto	/profˈitto/
profondamente	/profondamˈente/
profonda	/profˈonda/
profonde	/profˈonde/
profondi	/profˈondi/
profondissimo	/profondˈissimo/
profondità	/profonditˈa/
profondo	/profˈondo/
progenie	/prodʒenˈie/
progetto	/prodʒˈɛtto/
progresso	/proɡrˈɛsso/
prole	/prˈɔle/
promessa	/promˈessa/
promesse	/promˈesse/
promesso	/promˈesso/
promettendo	/promettˈɛndo/
promette	/promˈette/
prometto	/promˈetto/
promise	/promˈize/
promisi	/promˈizi/
promontorio	/promontˈɔrjo/
pronta	/prˈonta/
pronti	/prˈonti/
pronto	/prˈonto/
propia	/prˈɔpja/
propie	/prˈɔpje/
propii	/prˈɔpji/
propio	/prˈɔpjo/
proponimento	/proponimˈento/
proporre	/propˈorre/
propose	/propˈose/
proposito	/propˈɔzito/
proposta	/propˈosta/
proposto	/propˈosto/
propriamente	/proprjamˈente/
propria	/prˈɔprja/
proprie	/prˈɔprje/
proprietà	/proprjetˈa/
proprio	/prˈɔprjo/
propri	/prˈɔpri/
prosa	/prˈɔza/
prosatori	/prozatˈori/
proseguì	/proseɡwˈi/
prose	/prˈɔze/
prospere	/prˈɔspere/
prosperità	/prosperitˈa/
prospero	/prˈɔspero/
prossimo	/prˈɔssimo/
proteo	/prˈɔteo/
protesta	/protˈɛsta/
prova	/prˈɔva/
provare	/provˈare/
provata	/provˈata/
provate	/provˈate/
provato	/provˈato/
provava	/provˈava/
provenzale	/proventsˈale/
provenzali	/proventsˈali/
prove	/prˈɔve/
proverbio	/provˈɛrbjo/
provincia	/provˈintʃa/
provò	/provˈɔ/
provvidenza	/provvidˈɛntsa/
prudente	/prudˈɛnte/
prudenti	/prudˈɛnti/
prudenza	/prudˈɛntsa/
pruni	/prˈuni/
pruova	/prwˈɔva/
pubblicato	/pubblikˈato/
pubblicazione	/pubblikatstsjˈone/
pubblico	/ˈpubbliko/
publica	/ˈpublika/
publico	/ˈpubliko/
puccio	/ˈputʃtʃo/
puerili	/puerˈili/
puerizia	/puerˈitstsja/
puglia	/ˈpuʎʎa/
pugna	/ˈpuɲɲa/
pulcella	/pultʃˈɛlla/
punire	/punˈire/
punizione	/punitstsjˈone/
punta	/ˈpunta/
punte	/ˈpunte/
punti	/ˈpunti/
punto	/ˈpunto/
puoi	/pwˈɔi/
puo	/pwˈo/
può	/pwˈɔ/
puote	/pwˈɔte/
pura	/ˈpura/
purché	/purkˈe/
pure	/ˈpure/
purissimo	/purˈissimo/
purità	/puritˈa/
puro	/ˈpuro/
pur	/ˈpur/
purpureo	/purpˈureo/
puzzo	/ˈputstso/
quai	/kwˈai/
quà	/kwˈa/
qualche	/kwˈalke/
qualcosa	/kwalkˈɔsa/
quale	/kwˈale/
quali	/kwˈali/
qualità	/kwalitˈa/
qual	/kwal/
qualmente	/kwalmˈente/
qualora	/kwalˈora/
qualunque	/kwalˈuŋkwe/
quando	/kwˈando/
quanta	/kwˈanta/
quante	/kwˈante/
quanti	/kwˈanti/
quantità	/kwantitˈa/
quanto	/kwˈanto/
quantunque	/kwantˈuŋkwe/
quaranta	/kwarˈanta/
quarta	/kwˈarta/
quartodecimo	/kwartodˈɛtʃimo/
quarto	/kwˈarto/
quasi	/kwˈazi/
quattordici	/kwattˈorditʃi/
quattro	/kwˈattro/
quegli	/kwˈeʎʎi/
quei	/kwˈei/
que	/kwˈe/
quel	/kwˈel/
quella	/kwˈella/
quelle	/kwˈelle/
quelli	/kwˈelli/
quello	/kwˈello/
quercia	/kwˈɛrtʃa/
querela	/kwerˈɛla/
questa	/kwˈesta/
queste	/kwˈeste/
questi	/kwˈesti/
questione	/kwestjˈone/
questioni	/kwestjˈoni/
questo	/kwˈesto/
quiete	/kwjˈɛte/
quieto	/kwjˈɛto/
quì	/kwˈi/
quinci	/kwˈintʃi/
quindici	/kwˈinditʃi/
quindi	/kwˈindi/
quinta	/kwˈinta/
quintilio	/kwintˈiljo/
quintodecimo	/kwintodˈɛtʃimo/
quinto	/kwˈinto/
quivi	/kwˈivi/
rabbia	/ˈrabbja/
raccogliendo	/rakkoʎʎˈɛndo/
raccoglie	/rakkˈɔʎʎe/
raccogliere	/rakkˈɔʎʎere/
raccolse	/rakkˈɔlse/
raccolta	/rakkˈɔlta/
raccolte	/rakkˈɔlte/
raccolti	/rakkˈɔlti/
raccolto	/rakkˈɔlto/
raccomando	/rakkomˈando/
raccomandò	/rakkomandˈɔ/
racconta	/rakkˈonta/
raccontare	/rakkontˈare/
raccontata	/rakkontˈata/
raccontate	/rakkontˈate/
raccontato	/rakkontˈato/
racconti	/rakkˈonti/
raccontò	/rakkontˈɔ/
raddoppia	/raddˈoppja/
raddoppiata	/raddoppjˈata/
rade	/ˈrade/
radicale	/radikˈale/
radice	/radˈitʃe/
radici	/radˈitʃi/
rado	/ˈrado/
ragazzo	/raɡˈatstso/
raggio	/ˈradʒdʒo/
raggi	/ˈradʒdʒi/
ragguardatore	/raɡɡwardatˈore/
ragionamenti	/radʒonamˈenti/
ragionamento	/radʒonamˈento/
ragionando	/radʒonˈando/
ragiona	/radʒˈona/
ragionare	/radʒonˈare/
ragionate	/radʒonˈate/
ragionato	/radʒonˈato/
ragionavano	/radʒonˈavano/
ragionava	/radʒonˈava/
ragione	/radʒˈone/
ragionevole	/radʒonˈevole/
ragionevolmente	/radʒonevolmˈente/
ragioniamo	/radʒonjˈamo/
ragioni	/radʒˈoni/
ragiono	/radʒˈono/
ragionò	/radʒonˈɔ/
rallegrare	/ralleɡrˈare/
rallegrati	/ralleɡrˈati/
rame	/ˈrame/
rami	/ˈrami/
ramo	/ˈramo/
rapidamente	/rapidamˈente/
rapido	/ˈrapido/
rapina	/rapˈina/
rapita	/rapˈita/
rapito	/rapˈito/
rare	/ˈrare/
raro	/ˈraro/
ravenna	/ravˈenna/
razionale	/ratstsjonˈale/
reale	/reˈale/
reali	/reˈali/
realizzato	/realidzdzˈato/
realtà	/realtˈa/
reame	/reˈame/
reami	/reˈami/
rea	/ˈrɛa/
reazione	/reatstsjˈone/
recai	/rekˈai/
reca	/ˈrɛka/
recare	/rekˈare/
recarono	/rekˈarono/
recasse	/rekˈasse/
recata	/rekˈata/
recate	/rekˈate/
recati	/rekˈati/
recato	/rekˈato/
rechi	/ˈrɛki/
recita	/ˈrɛtʃita/
recò	/rekˈɔ/
redenzione	/redentsjˈone/
redine	/ˈrɛdine/
ree	/ˈrɛe/
regge	/ˈrɛdʒdʒe/
reggere	/ˈrɛdʒdʒere/
reggeva	/redʒdʒˈeva/
reggimento	/redʒdʒimˈento/
reggono	/ˈrɛɡɡono/
regina	/redʒˈina/
regione	/redʒˈone/
regioni	/redʒˈoni/
regnando	/reɲɲˈando/
regnare	/reɲɲˈare/
regnasse	/reɲɲˈasse/
regnato	/reɲɲˈato/
regnava	/reɲɲˈava/
regni	/ˈreɲɲi/
regno	/ˈreɲɲo/
regnò	/reɲɲˈɔ/
regola	/ˈrɛɡola/
regole	/ˈrɛɡole/
reina	/reˈina/
rei	/ˈrɛi/
religione	/relidʒˈone/
religioni	/relidʒˈoni/
religiosa	/relidʒˈosa/
religiosi	/relidʒˈosi/
religioso	/relidʒˈoso/
reliquie	/relˈikwje/
remi	/ˈrɛmi/
remo	/ˈrɛmo/
renda	/ˈrɛnda/
rendendo	/rendˈɛndo/
rende	/ˈrɛnde/
rendé	/rendˈe/
rendere	/ˈrɛndere/
rendono	/ˈrɛndono/
rendo	/ˈrɛndo/
renduta	/rendˈuta/
rendute	/rendˈute/
renduto	/rendˈuto/
reni	/ˈrɛni/
reo	/ˈrɛo/
repubblicana	/repubblikˈana/
repubblicano	/repubblikˈano/
repubblica	/repˈubblika/
reputata	/reputˈata/
reputato	/reputˈato/
reputava	/reputˈava/
reputo	/ˈrɛputo/
re	/ˈrɛ/
rese	/ˈrese/
resistente	/resistˈɛnte/
resistenti	/resistˈɛnti/
resistenza	/resistˈɛntsa/
resistere	/resˈistere/
restando	/restˈando/
restano	/ˈrɛstano/
resta	/ˈrɛsta/
restare	/restˈare/
restarono	/restˈarono/
restasse	/restˈasse/
restato	/restˈato/
restava	/restˈava/
restituita	/restituˈita/
resto	/ˈrɛsto/
restò	/restˈɔ/
reti	/ˈreti/
reverenza	/reverˈɛntsa/
riavere	/riavˈere/
ricca	/ˈrikka/
ricche	/ˈrikke/
ricchezza	/rikkˈetstsa/
ricchezze	/rikkˈetstse/
ricchi	/ˈrikki/
ricchissima	/rikkˈissima/
ricchissimi	/rikkˈissimi/
ricchissimo	/rikkˈissimo/
ricco	/ˈrikko/
ricercando	/ritʃerkˈando/
ricercare	/ritʃerkˈare/
ricerca	/ritʃˈerka/
ricercata	/ritʃerkˈata/
ricercato	/ritʃerkˈato/
ricetto	/ritʃˈɛtto/
riceva	/ritʃˈeva/
ricevere	/ritʃˈevere/
riceve	/ritʃˈeve/
ricevette	/ritʃevˈɛtte/
ricevetti	/ritʃevˈɛtti/
ricevi	/ritʃˈevi/
ricevuta	/ritʃevˈuta/
ricevute	/ritʃevˈute/
ricevuti	/ritʃevˈuti/
ricevuto	/ritʃevˈuto/
richiedere	/rikjˈɛdere/
richiede	/rikjˈɛde/
richiedeva	/rikjedˈeva/
richiese	/rikjˈɛse/
richiesta	/rikjˈɛsta/
richiesto	/rikjˈɛsto/
ricominciò	/rikomintʃˈɔ/
riconfortata	/rikonffortˈata/
riconobbe	/rikonˈobbe/
riconoscenza	/rikonoʃʃˈɛntsa/
riconoscere	/rikonˈoʃʃere/
riconosciuta	/rikonoʃʃˈuta/
riconosciuto	/rikonoʃʃˈuto/
ricordanza	/rikordˈantsa/
ricordare	/rikordˈare/
ricorda	/rikˈɔrda/
ricordata	/rikordˈata/
ricordate	/rikordˈate/
ricordato	/rikordˈato/
ricordava	/rikordˈava/
ricordi	/rikˈɔrdi/
ricordo	/rikˈɔrdo/
ricordò	/rikordˈɔ/
ridendo	/ridˈɛndo/
ridente	/ridˈɛnte/
ridere	/ˈridere/
ride	/ˈride/
rideva	/ridˈeva/
ridire	/ridˈire/
ridotti	/ridˈotti/
ridotto	/ridˈotto/
ridusse	/ridˈusse/
rientrare	/rientrˈare/
rientrò	/rientrˈɔ/
riforme	/rifˈorme/
rifugio	/rifˈudʒo/
rigido	/ˈridʒido/
riguardando	/riɡwardˈando/
riguardanti	/riɡwardˈanti/
riguardare	/riɡwardˈare/
riguarda	/riɡwˈarda/
riguardate	/riɡwardˈate/
riguardato	/riɡwardˈato/
riguardavano	/riɡwardˈavano/
riguardava	/riɡwardˈava/
riguardevole	/riɡwardˈevole/
riguardevoli	/riɡwardˈevoli/
riguardi	/riɡwˈardi/
riguardo	/riɡwˈardo/
riguardò	/riɡwardˈɔ/
rimanendo	/rimanˈɛndo/
rimanente	/rimanˈɛnte/
rimanenti	/rimanˈɛnti/
rimanere	/rimˈanere/
rimane	/rimˈane/
rimanesse	/rimanˈesse/
rimaneva	/rimanˈeva/
rimanga	/rimˈaŋɡa/
rimangono	/rimˈaŋɡono/
rima	/ˈrima/
rimarrà	/rimarrˈa/
rimasa	/rimˈasa/
rimase	/rimˈase/
rimasero	/rimˈasero/
rimasi	/rimˈasi/
rimaso	/rimˈaso/
rimasta	/rimˈasta/
rimasto	/rimˈasto/
rimedio	/rimˈɛdjo/
rimedi	/rimˈɛdi/
rimessa	/rimˈessa/
rimesso	/rimˈesso/
rimettere	/rimˈettere/
rimirando	/rimirˈando/
rimirare	/rimirˈare/
rimira	/rimˈira/
rimirava	/rimirˈava/
rimise	/rimˈize/
rimosse	/rimˈɔsse/
rimprovero	/rimprˈɔvero/
rimuovere	/rimwˈɔvere/
rinaldo	/rinˈaldo/
rinchiusa	/riŋkjˈusa/
rinchiuse	/riŋkjˈuse/
rinchiusi	/riŋkjˈusi/
rinchiuso	/riŋkjˈuso/
ringraziando	/riŋɡratstsjˈando/
ringraziare	/riŋɡratstsjˈare/
ringrazio	/riŋɡrˈatstsjo/
ringraziò	/riŋɡratstsjˈɔ/
ripa	/ˈripa/
riparo	/ripˈaro/
ripe	/ˈripe/
ripiena	/ripjˈɛna/
ripieno	/ripjˈɛno/
ripigliando	/ripiʎʎˈando/
ripigliare	/ripiʎʎˈare/
riportò	/riportˈɔ/
riposata	/riposˈata/
riposato	/riposˈato/
ripose	/ripˈose/
riposi	/ripˈɔsi/
riposo	/ripˈɔso/
riposti	/ripˈosti/
riposto	/ripˈosto/
riprendere	/riprˈɛndere/
riprensione	/riprensjˈone/
riprensioni	/riprensjˈoni/
riprensori	/riprensˈori/
ripresa	/riprˈesa/
riprese	/riprˈese/
ripreso	/riprˈeso/
risaltare	/risaltˈare/
risapesse	/risapˈesse/
risa	/ˈrisa/
riscaldato	/riskaldˈato/
rise	/ˈrise/
risguardo	/rizɡwˈardo/
risolve	/risˈɔlve/
risonanti	/risonˈanti/
risonare	/risonˈare/
risorgimento	/risordʒimˈento/
riso	/ˈriso/
rispetto	/rispˈɛtto/
risplendente	/risplendˈɛnte/
risponda	/rispˈonda/
rispondendo	/rispondˈɛndo/
rispondere	/rispˈondere/
risponde	/rispˈonde/
rispondesse	/rispondˈesse/
rispondeva	/rispondˈeva/
rispose	/rispˈose/
risposero	/rispˈosero/
risposi	/rispˈɔzi/
risposta	/rispˈosta/
risposte	/rispˈoste/
risposto	/rispˈosto/
ristette	/ristˈette/
ristorare	/ristorˈare/
ristretti	/ristrˈetti/
risuona	/riswˈɔna/
risuscitato	/risuʃʃitˈato/
ritegno	/ritˈɛɲɲo/
ritenere	/ritenˈere/
ritenne	/ritˈenne/
ritenuto	/ritenˈuto/
ritiene	/ritjˈɛne/
ritondo	/ritˈondo/
ritornando	/ritornˈando/
ritornano	/ritˈornano/
ritornare	/ritornˈare/
ritorna	/ritˈorna/
ritornarono	/ritornˈarono/
ritornasse	/ritornˈasse/
ritornata	/ritornˈata/
ritornato	/ritornˈato/
ritornava	/ritornˈava/
ritorni	/ritˈorni/
ritorno	/ritˈorno/
ritornò	/ritornˈɔ/
ritrarre	/ritrˈarre/
ritratto	/ritrˈatto/
ritrosa	/ritrˈosa/
ritrovando	/ritrovˈando/
ritrovare	/ritrovˈare/
ritrova	/ritrˈɔva/
ritrovarono	/ritrovˈarono/
ritrovasse	/ritrovˈasse/
ritrovata	/ritrovˈata/
ritrovati	/ritrovˈati/
ritrovato	/ritrovˈato/
ritrovò	/ritrovˈɔ/
riuscire	/riuʃʃˈire/
riuscì	/riuʃʃˈi/
riuscita	/riuʃʃˈita/
riuscito	/riuʃʃˈito/
riusciva	/riuʃʃˈiva/
riva	/ˈriva/
rivedere	/rivedˈere/
riverenza	/riverˈɛntsa/
rive	/ˈrive/
rivestire	/rivestˈire/
rivestito	/rivestˈito/
rivolgea	/rivoldʒˈɛa/
rivolgendo	/rivoldʒˈɛndo/
rivolgere	/rivˈɔldʒere/
rivolge	/rivˈɔldʒe/
rivolse	/rivˈɔlse/
rivolta	/rivˈɔlta/
rivolti	/rivˈɔlti/
rivolto	/rivˈɔlto/
rivoluzione	/rivolutstsjˈone/
roberto	/robˈɛrto/
robespierre	/robespjˈɛrre/
robusto	/robˈusto/
rocca	/ˈrɔkka/
rodano	/ˈrodano/
rodi	/ˈrɔdi/
rogo	/ˈrɔɡo/
romagna	/romˈaɲɲa/
romana	/romˈana/
romani	/romˈani/
romano	/romˈano/
romanzo	/romˈandzo/
roma	/ˈroma/
romolo	/ˈrɔmolo/
rompere	/ˈrompere/
rompe	/ˈrompe/
ronzino	/rondzˈino/
rosa	/ˈrɔza/
rose	/ˈrose/
rossa	/ˈrossa/
rossi	/ˈrossi/
rossore	/rossˈore/
rosso	/ˈrosso/
rota	/ˈrɔta/
rotta	/ˈrotta/
rotte	/ˈrotte/
rotti	/ˈrotti/
rotto	/ˈrotto/
rovina	/rovˈina/
rovinata	/rovinˈata/
rozza	/ˈrɔtstsa/
rozze	/ˈrɔtstse/
rozzi	/ˈrodzdzi/
rozzo	/ˈrodzdzo/
rubato	/rubˈato/
ruggieri	/rudʒdʒˈeri/
rugiada	/rudʒˈada/
ruina	/ruˈina/
ruine	/ruˈine/
rumore	/rumˈore/
ruota	/rwˈɔta/
ruote	/rwˈɔte/
rupe	/ˈrupe/
ruppe	/ˈruppe/
rustico	/ˈrustiko/
sabato	/ˈsabato/
s'accostarono	/sakkostˈarono/
sacerdote	/satʃerdˈɔte/
sacerdoti	/satʃerdˈɔti/
sacra	/ˈsakra/
sacrato	/sakrˈato/
sacre	/ˈsakre/
sacrificando	/sakrifikˈando/
sacrificare	/sakrifikˈare/
sacrificii	/sakrifˈitʃii/
sacrificio	/sakrifˈitʃo/
sacrifici	/sakrifˈitʃi/
sacrifizio	/sakrifˈitstsjo/
sacri	/ˈsakri/
sacro	/ˈsakro/
saettamento	/saettamˈento/
saetta	/saˈetta/
saette	/saˈette/
sagacità	/saɡatʃitˈa/
saggio	/ˈsadʒdʒo/
saggi	/ˈsadʒdʒi/
sai	/ˈsai/
saladino	/saladˈino/
salamone	/salamˈone/
sala	/ˈsala/
salate	/salˈate/
salendo	/salˈɛndo/
salerno	/salˈɛrno/
sale	/ˈsale/
salire	/salˈire/
salì	/salˈi/
saliti	/salˈiti/
salito	/salˈito/
saliva	/salˈiva/
salomone	/salomˈone/
salutata	/salutˈata/
salute	/salˈute/
saluto	/salˈuto/
salutò	/salutˈɔ/
salva	/ˈsalva/
salvatico	/salvˈatiko/
salvatore	/salvatˈore/
salvezza	/salvˈetstsa/
salvia	/ˈsalvja/
salvi	/ˈsalvi/
salvo	/ˈsalvo/
sanamente	/sanamˈente/
sana	/ˈsana/
s'andò	/sandˈɔ/
sangue	/ˈsaŋɡwe/
sanguinosi	/saŋɡwinˈosi/
sanguinoso	/saŋɡwinˈoso/
sani	/ˈsani/
sanità	/sanitˈa/
sanno	/ˈsanno/
sano	/ˈsano/
san	/ˈsan/
santa	/ˈsanta/
sante	/ˈsante/
santifica	/santˈifika/
santi	/ˈsanti/
santissima	/santˈissima/
santissimi	/santˈissimi/
santissimo	/santˈissimo/
santità	/santitˈa/
santo	/ˈsanto/
sanza	/ˈsantsa/
sapendo	/sapˈɛndo/
sapere	/sapˈere/
saperlo	/sapˈerlo/
sapessero	/sapˈessero/
sapesse	/sapˈesse/
sapessi	/sapˈessi/
sapeste	/sapˈeste/
sapete	/sapˈete/
sapevano	/sapˈevano/
sapeva	/sapˈeva/
sapienza	/sapjˈɛntsa/
sapore	/sapˈore/
sappiamo	/sappjˈamo/
sappia	/ˈsappja/
sappiate	/sappjˈate/
sappiendo	/sappjˈɛndo/
sappi	/ˈsappi/
saprà	/saprˈa/
saprei	/saprˈɛi/
saprò	/saprˈɔ/
saputa	/sapˈuta/
saputo	/sapˈuto/
saracini	/saratʃˈini/
sarai	/sarˈai/
saranno	/sarˈanno/
sarà	/sarˈa/
sardigna	/sardˈiɲɲa/
sarebbero	/sarˈɛbbero/
sarebbe	/sarˈɛbbe/
sarei	/sarˈɛi/
saremmo	/sarˈemmo/
saremo	/sarˈemo/
saresti	/sarˈesti/
sarete	/sarˈete/
saria	/sarˈia/
sarò	/sarˈɔ/
sa	/ˈsa/
sassi	/ˈsassi/
sasso	/ˈsasso/
saturnali	/saturnˈali/
saturno	/satˈurno/
saviamente	/savjamˈente/
savia	/ˈsavja/
savie	/ˈsavje/
savio	/ˈsavjo/
savi	/ˈsavi/
sazia	/ˈsatstsja/
sazietà	/satstsjetˈa/
scacchi	/skˈakki/
scacciato	/skatʃtʃˈato/
scala	/skˈala/
scalza	/skˈaltsa/
scambiò	/skambjˈɔ/
scampa	/skˈampa/
scampo	/skˈampo/
scendendo	/ʃendˈɛndo/
scendere	/ˈʃendere/
scende	/ˈʃende/
scene	/ˈʃɛne/
scesa	/ˈʃesa/
scese	/ˈʃese/
sceso	/ˈʃeso/
scettro	/ˈʃɛttro/
scherzando	/skertsˈando/
scherzi	/skˈertsi/
schiave	/skjˈave/
schiera	/skjˈɛra/
schiere	/skjˈɛre/
schifare	/skifˈare/
sciagura	/ʃaɡˈura/
sciagure	/ʃaɡˈure/
scienza	/ˈʃɛntsa/
scienze	/ˈʃɛntse/
scienziati	/ʃentsjˈati/
sciocca	/ˈʃɔkka/
sciocche	/ˈʃɔkke/
sciocchezza	/ʃokkˈetstsa/
sciocchi	/ˈʃɔkki/
sciocco	/ˈʃɔkko/
sciogliere	/ˈʃɔʎʎere/
scipione	/ʃipjˈone/
scolare	/skolˈare/
scolastica	/skolˈastika/
sconce	/skˈontʃe/
sconciamente	/skontʃamˈente/
sconcia	/skˈontʃa/
sconsolata	/skonsolˈata/
scoperse	/skopˈɛrse/
scoperta	/skopˈɛrta/
scoperto	/skopˈɛrto/
scopo	/skˈɔpo/
scoppio	/skˈɔppjo/
scoprire	/skoprˈire/
scorgere	/skˈɔrdʒere/
scorpione	/skorpjˈone/
scorta	/skˈɔrta/
scossa	/skˈɔssa/
scosse	/skˈɔsse/
scrissero	/skrˈissero/
scrisse	/skrˈisse/
scritta	/skrˈitta/
scritte	/skrˈitte/
scritti	/skrˈitti/
scrittore	/skrittˈore/
scrittori	/skrittˈori/
scritto	/skrˈitto/
scrittura	/skrittˈura/
scritture	/skrittˈure/
scriva	/skrˈiva/
scrivendo	/skrivˈɛndo/
scriverà	/skriverˈa/
scrivere	/skrˈivere/
scrive	/skrˈive/
scrivi	/skrˈivi/
scrivono	/skrˈivono/
scudo	/skˈudo/
scuola	/skwˈɔla/
scuole	/skwˈɔle/
scure	/skˈure/
scusare	/skuzˈare/
scusa	/skˈuza/
sdegnata	/zdeɲɲˈata/
sdegnato	/zdeɲɲˈato/
sdegni	/zdˈeɲɲi/
sdegnoso	/zdeɲɲˈoso/
sdegno	/zdˈeɲɲo/
sdrucciolosa	/zdrutʃtʃolˈosa/
sebastiano	/sebastjˈano/
sebbene	/sebbˈɛne/
secca	/ˈsekka/
secco	/ˈsekko/
secolari	/sekolˈari/
secoli	/ˈsɛkoli/
secolo	/ˈsɛkolo/
seconda	/sekˈonda/
seconde	/sekˈonde/
secondo	/sekˈondo/
seco	/ˈseko/
securo	/sekˈuro/
sedendo	/sedˈɛndo/
sedere	/sedˈere/
sedeva	/sedˈeva/
sedia	/ˈsɛdja/
sedie	/ˈsɛdje/
seggiolone	/sedʒdʒolˈone/
seggio	/ˈsɛdʒdʒo/
segnale	/seɲɲˈale/
segnali	/seɲɲˈali/
segnato	/seɲɲˈato/
segni	/ˈseɲɲi/
segno	/ˈseɲɲo/
segretamente	/seɡretamˈente/
segreta	/seɡrˈeta/
segreti	/seɡrˈeti/
segreto	/seɡrˈeto/
seguaci	/seɡwˈatʃi/
segua	/ˈseɡwa/
seguendo	/seɡwˈɛndo/
seguente	/seɡwˈɛnte/
seguenti	/seɡwˈɛnti/
segue	/ˈseɡwe/
seguirà	/seɡwirˈa/
seguire	/seɡwˈire/
seguirò	/seɡwirˈɔ/
seguì	/seɡwˈi/
seguisse	/seɡwˈisse/
seguitando	/seɡwitˈando/
seguitare	/seɡwitˈare/
seguita	/seɡwˈita/
seguitasse	/seɡwitˈasse/
seguiti	/seɡwˈiti/
seguito	/seɡwˈito/
seguitò	/seɡwitˈɔ/
seguiva	/seɡwˈiva/
seguivi	/seɡwˈivi/
seguono	/ˈseɡwono/
sei	/ˈsɛi/
selvaggio	/selvˈadʒdʒo/
selvaggi	/selvˈadʒdʒi/
selva	/ˈselva/
selve	/ˈselve/
sembiante	/sembjˈante/
sembianti	/sembjˈanti/
sembianza	/sembjˈantsa/
sembianze	/sembjˈantse/
seme	/ˈseme/
seminò	/seminˈɔ/
semi	/ˈsemi/
semiviva	/semivˈiva/
sempiterna	/sempitˈɛrna/
semplicemente	/semplitʃemˈente/
semplice	/ˈsemplitʃe/
semplici	/ˈsemplitʃi/
semplicità	/semplitʃitˈa/
sempre	/ˈsɛmpre/
senno	/ˈsenno/
sensibile	/sensˈibile/
sensi	/ˈsɛnsi/
senso	/ˈsɛnso/
senta	/ˈsɛnta/
sentendo	/sentˈɛndo/
sentenza	/sentˈɛntsa/
sentenze	/sentˈɛntse/
sentenzia	/sentˈɛntsja/
sente	/ˈsɛnte/
sentiamo	/sentiˈamo/
sentiero	/sentjˈɛro/
sentii	/sentˈii/
sentimenti	/sentimˈenti/
sentimento	/sentimˈento/
sentire	/sentˈire/
sentirono	/sentˈirono/
senti	/ˈsɛnti/
sentì	/sentˈi/
sentisse	/sentˈisse/
sentissi	/sentˈissi/
sentita	/sentˈita/
sentite	/sentˈite/
sentito	/sentˈito/
sentiva	/sentˈiva/
sentono	/ˈsɛntono/
sento	/ˈsɛnto/
senza	/ˈsɛntsa/
separatamente	/separatamˈente/
separate	/separˈate/
separato	/separˈato/
sepolcro	/sepˈolkro/
sepolti	/sepˈolti/
sepolto	/sepˈolto/
sepoltura	/sepoltˈura/
seppero	/ˈsɛppero/
seppe	/ˈsɛppe/
seppi	/ˈsɛppi/
s'era	/ˈsera/
sera	/ˈsera/
serbano	/ˈsɛrbano/
serbare	/serbˈare/
serba	/ˈsɛrba/
serbato	/serbˈato/
serena	/serˈena/
serenissimo	/serenˈissimo/
serenità	/serenitˈa/
sereno	/serˈeno/
sere	/ˈsɛre/
sergenti	/serdʒˈɛnti/
seria	/ˈsɛrja/
serie	/ˈsɛrje/
serpente	/serpˈɛnte/
serpenti	/serpˈɛnti/
serpe	/ˈsɛrpe/
serrata	/serrˈata/
serrato	/serrˈato/
serrò	/serrˈɔ/
ser	/ˈsɛr/
servano	/ˈsɛrvano/
serva	/ˈsɛrva/
servente	/servˈɛnte/
serventi	/servˈɛnti/
serve	/ˈsɛrve/
servigio	/servˈidʒo/
servigi	/servˈidʒi/
servile	/servˈile/
servire	/servˈire/
servi	/ˈsɛrvi/
servita	/servˈita/
serviti	/servˈiti/
servito	/servˈito/
servitù	/servitˈu/
servivano	/servˈivano/
serviva	/servˈiva/
servono	/ˈsɛrvono/
servo	/ˈsɛrvo/
se	/se/
sé	/ˈse/
sesso	/ˈsɛsso/
sesta	/ˈsɛsta/
sesto	/ˈsɛsto/
sete	/ˈsɛte/
setta	/ˈsɛtta/
settembre	/settˈɛmbre/
settentrione	/settentrjˈone/
sette	/ˈsɛtte/
settimana	/settimˈana/
settimane	/settimˈane/
settima	/ˈsɛttima/
settimo	/ˈsɛttimo/
severa	/sevˈɛra/
severo	/sevˈɛro/
sforza	/sfˈɔrtsa/
sforzato	/sfortsˈato/
sfuggire	/sfudʒdʒˈire/
sgomento	/zɡomˈento/
sguardi	/zɡwˈardi/
sguardo	/zɡwˈardo/
siamo	/sjˈamo/
siano	/ˈsiano/
sia	/ˈsia/
siate	/sjˈate/
sibilla	/sibˈilla/
siccome	/sikkˈome/
sicilia	/sitʃˈilia/
sic	/ˈsik/
sicuramente	/sikuramˈente/
sicura	/sikˈura/
sicurezza	/sikurˈetstsa/
sicuri	/sikˈuri/
sicuro	/sikˈuro/
sicurtà	/sikurtˈa/
siede	/sjˈɛde/
siena	/sjˈɛna/
sieno	/ˈsieno/
siete	/sjˈɛte/
significare	/siɲɲifikˈare/
significa	/siɲɲˈifika/
significato	/siɲɲifikˈato/
signora	/siɲɲˈora/
signoreggia	/siɲɲorˈedʒdʒa/
signoreggiato	/siɲɲoredʒdʒˈato/
signoreggiava	/siɲɲoredʒdʒˈava/
signoreggiò	/siɲɲoredʒdʒˈɔ/
signore	/siɲɲˈore/
signoria	/siɲɲorˈia/
signorina	/siɲɲorˈina/
signori	/siɲɲˈori/
sii	/ˈsii/
silenzio	/silˈɛntsjo/
sillaba	/ˈsillaba/
sillabe	/ˈsillabe/
silvio	/ˈsilvjo/
simile	/ˈsimile/
simili	/ˈsimili/
similitudine	/similitˈudine/
similmente	/similmˈente/
simona	/simˈona/
simone	/simˈone/
simpatia	/simpatˈia/
s'impazientì	/simpatstsjentˈi/
simulacro	/simulˈakro/
sincera	/sintʃˈɛra/
sincerità	/sintʃeritˈa/
sincero	/sintʃˈɛro/
singolare	/siŋɡolˈare/
singulare	/siŋɡulˈare/
siniscalco	/siniskˈalko/
sinistra	/sinˈistra/
sinistro	/sinˈistro/
sino	/ˈsino/
sin	/ˈsin/
sintesi	/ˈsintezi/
siringa	/sirˈiŋɡa/
si	/ˈsi/
sì	/ˈsi/
sistema	/sistˈɛma/
sito	/ˈsito/
sit	/ˈsit/
situazione	/situatstsjˈone/
slancio	/zlˈantʃo/
smarrita	/zmarrˈita/
smarriti	/zmarrˈiti/
smarrito	/zmarrˈito/
smemorato	/zmemorˈato/
smontati	/zmontˈati/
smontato	/zmontˈato/
soavemente	/soavemˈente/
soave	/soˈave/
soavi	/soˈavi/
soavità	/soavitˈa/
soccorso	/sokkˈorso/
sociale	/sotʃˈale/
società	/sotʃetˈa/
socrate	/ˈsɔkrate/
soddisfazione	/soddisfatstsjˈone/
sofferente	/sofferˈɛnte/
sofferenza	/sofferˈɛntsa/
sofferse	/soffˈɛrse/
sofferto	/soffˈɛrto/
soffiando	/soffjˈando/
soffiare	/soffjˈare/
sofficiente	/soffitʃˈɛnte/
soffrire	/soffrˈire/
soggiunse	/sodʒdʒˈunse/
soglia	/ˈsɔʎʎa/
sogliono	/ˈsɔʎʎono/
sogni	/ˈsoɲɲi/
sogno	/ˈsoɲɲo/
solamente	/solamˈente/
solari	/solˈari/
sola	/ˈsola/
soldato	/soldˈato/
soldi	/ˈsɔldi/
solenne	/solˈɛnne/
solenni	/solˈɛnni/
solennità	/solennitˈa/
sole	/ˈsole/
soleva	/solˈeva/
solevi	/solˈevi/
solingo	/solˈiŋɡo/
solino	/solˈino/
soli	/ˈsoli/
solitaria	/solitˈarja/
solitario	/solitˈarjo/
solita	/ˈsɔlita/
solite	/ˈsɔlite/
soliti	/ˈsɔliti/
solito	/ˈsɔlito/
solitudine	/solitˈudine/
solitudini	/solitˈudini/
sollazzando	/sollatstsˈando/
sollazzi	/sollˈatstsi/
sollazzo	/sollˈatstso/
sollecitamente	/solletʃitamˈente/
sollecita	/solletʃˈita/
solleciti	/solletʃˈiti/
sollecito	/solletʃˈito/
sollecitudine	/solletʃitˈudine/
sollecitudini	/solletʃitˈudini/
solo	/ˈsolo/
sol	/ˈsɔl/
soltanto	/soltˈanto/
somigliante	/somiʎʎˈante/
somiglianti	/somiʎʎˈanti/
somiglianza	/somiʎʎˈantsa/
sommamente	/sommamˈente/
somma	/ˈsomma/
sommessa	/sommˈessa/
sommi	/ˈsommi/
sommità	/sommitˈa/
sommo	/ˈsommo/
sonando	/sonˈando/
sonanti	/sonˈanti/
sonare	/sonˈare/
sonarono	/sonˈarono/
sonetti	/sonˈetti/
sonmi	/ˈsɔnmi/
sonni	/ˈsonni/
sonno	/ˈsonno/
sonoro	/sonˈɔro/
sono	/ˈsɔno/
soperchio	/sopˈɛrkjo/
sopportando	/sopportˈando/
sopportare	/sopportˈare/
sopportò	/sopportˈɔ/
sopra	/ˈsopra/
sorda	/ˈsorda/
sorella	/sorˈɛlla/
sorelle	/sorˈɛlle/
sorga	/ˈsɔrɡa/
sorpresa	/sorprˈesa/
sorridendo	/sorridˈɛndo/
sorridere	/sorrˈidere/
sorriso	/sorrˈiso/
sorte	/ˈsɔrte/
sorti	/ˈsɔrti/
so	/ˈso/
sospesi	/sospˈesi/
sospeso	/sospˈeso/
sospetti	/sospˈɛtti/
sospetto	/sospˈɛtto/
sospinto	/sospˈinto/
sospirando	/sospirˈando/
sospirare	/sospirˈare/
sospiri	/sospˈiri/
sospiro	/sospˈiro/
sostanza	/sostˈantsa/
sostanze	/sostˈantse/
sostegno	/sostˈɛɲɲo/
sostenendo	/sostenˈɛndo/
sostenere	/sostenˈere/
sosteneva	/sostenˈeva/
sostenga	/sostˈɛŋɡa/
sostennero	/sostˈennero/
sostenne	/sostˈenne/
sostenuta	/sostenˈuta/
sostenute	/sostenˈute/
sostenuto	/sostenˈuto/
sostiene	/sostjˈɛne/
sostieni	/sostjˈɛni/
sostituire	/sostituˈire/
sotterra	/sottˈɛrra/
sotterrato	/sotterrˈato/
sottile	/sottˈile/
sottili	/sottˈili/
sottilissimo	/sottilˈissimo/
sottilmente	/sottilmˈente/
sottoposta	/sottopˈosta/
sottoposti	/sottopˈosti/
sotto	/ˈsotto/
sovente	/sovˈɛnte/
soverchia	/sovˈɛrkja/
soverchio	/sovˈɛrkjo/
sovra	/ˈsovra/
sozzo	/ˈsotstso/
spada	/spˈada/
spade	/spˈade/
spagna	/spˈaɲɲa/
spalla	/spˈalla/
spalle	/spˈalle/
sparse	/spˈarse/
sparsi	/spˈarsi/
sparte	/spˈarte/
sparve	/spˈarve/
spaventato	/spaventˈato/
spaventevoli	/spaventˈevoli/
spavento	/spavˈento/
spazio	/spˈatstsjo/
specchio	/spˈɛkkjo/
specialmente	/spetʃalmˈente/
specie	/spˈɛtʃe/
specificata	/spetʃifikˈata/
spelonca	/spelˈoŋka/
spelonche	/spelˈoŋke/
speme	/spˈɛme/
spendendo	/spendˈɛndo/
spendere	/spˈɛndere/
spento	/spˈɛnto/
speranza	/sperˈantsa/
speranze	/sperˈantse/
spera	/spˈɛra/
spesa	/spˈesa/
spese	/spˈese/
speso	/spˈeso/
spesse	/spˈesse/
spessissime	/spessˈissime/
spesso	/spˈesso/
speziale	/spetstsjˈale/
spezie	/spˈɛtstsje/
spiacevole	/spjatʃˈevole/
spiare	/spiˈare/
spiegazione	/spjeɡatstsjˈone/
spina	/spˈina/
spine	/spˈine/
spiraglio	/spirˈaʎʎo/
spirito	/spˈirito/
splendente	/splendˈɛnte/
splendido	/splˈɛndido/
splendore	/splendˈore/
splendori	/splendˈori/
spogliare	/spoʎʎˈare/
spoglia	/spˈɔʎʎa/
spogliati	/spoʎʎˈati/
spogliato	/spoʎʎˈato/
spontanea	/spontˈanea/
sposa	/spˈɔza/
spose	/spˈɔze/
sposi	/spˈɔzi/
sposo	/spˈɔzo/
sposò	/spozˈɔ/
sprezzando	/spretstsˈando/
sprezzare	/spretstsˈare/
sprezzata	/spretstsˈata/
sprezzate	/spretstsˈate/
sprezzato	/spretstsˈato/
stabile	/stˈabile/
stabilità	/stabilitˈa/
stagione	/stadʒˈone/
stagioni	/stadʒˈoni/
stai	/stˈai/
stalla	/stˈalla/
stamane	/stamˈane/
stanco	/stˈaŋko/
stando	/stˈando/
stanotte	/stanˈɔtte/
stante	/stˈante/
stare	/stˈare/
stassi	/stˈassi/
sta	/stˈa/
stata	/stˈata/
state	/stˈate/
stati	/stˈati/
stato	/stˈato/
statua	/stˈatua/
statue	/stˈatue/
statura	/statˈura/
statuto	/statˈuto/
stavano	/stˈavano/
stava	/stˈava/
stella	/stˈella/
stelle	/stˈelle/
stende	/stˈɛnde/
sterco	/stˈɛrko/
sterile	/stˈɛrile/
stese	/stˈese/
stessa	/stˈessa/
stesse	/stˈesse/
stessi	/stˈessi/
stesso	/stˈesso/
stia	/stˈia/
stile	/stˈile/
stima	/stˈima/
stimolato	/stimolˈato/
stimoli	/stˈimoli/
stimolo	/stˈimolo/
stimo	/stˈimo/
stirpe	/stˈirpe/
stoltamente	/stoltamˈente/
stolta	/stˈolta/
stolti	/stˈolti/
stomaco	/stˈɔmako/
stordito	/stordˈito/
storia	/stˈɔrja/
storica	/stˈɔrika/
storiche	/stˈɔrike/
storico	/stˈɔriko/
sto	/stˈo/
stracciato	/stratʃtʃˈato/
strada	/strˈada/
strade	/strˈade/
stradoni	/stradˈoni/
stramba	/strˈamba/
strana	/strˈana/
strane	/strˈane/
straniera	/stranjˈɛra/
straniere	/stranjˈɛre/
stranieri	/stranjˈɛri/
straniero	/stranjˈɛro/
strani	/strˈani/
strano	/strˈano/
strazio	/strˈatstsjo/
strepiti	/strˈɛpiti/
strepito	/strˈɛpito/
strettamente	/strettamˈente/
stretta	/strˈetta/
strette	/strˈette/
stretti	/strˈetti/
stretto	/strˈetto/
strido	/strˈido/
strigne	/strˈiɲɲe/
strinse	/strˈinse/
strozza	/strˈɔtstsa/
strumenti	/strumˈenti/
studiare	/studjˈare/
studiato	/studjˈato/
studii	/stˈudji/
studioso	/studjˈoso/
studio	/stˈudjo/
studi	/stˈudi/
stupefatto	/stupefˈatto/
sua	/ˈsua/
sue	/swe/
suggeriti	/sudʒdʒˈɛriti/
surgea	/surdʒˈɛa/
su	/su/
tabarro	/tabˈarro/
taccio	/ˈtatʃtʃo/
tacendo	/tatʃˈɛndo/
tacere	/tatʃˈere/
taceva	/tatʃˈeva/
tacitamente	/tatʃitamˈente/
tacita	/ˈtatʃita/
taciti	/ˈtatʃiti/
tacito	/ˈtatʃito/
taciuto	/tatʃˈuto/
tacque	/ˈtakkwe/
tagliata	/taʎʎˈata/
tai	/ˈtai/
tale	/ˈtale/
tali	/ˈtali/
talora	/talˈora/
tal	/ˈtal/
taluno	/talˈuno/
talvolta	/talvˈɔlta/
tancredi	/taŋkrˈedi/
tandem	/ˈtandem/
tanta	/ˈtanta/
tante	/ˈtante/
tanti	/ˈtanti/
tanto	/ˈtanto/
tarda	/ˈtarda/
tardi	/ˈtardi/
tardo	/ˈtardo/
tartaro	/ˈtartaro/
tauro	/ˈtauro/
tavola	/ˈtavola/
tavole	/ˈtavole/
tavolo	/ˈtavolo/
tebano	/tebˈano/
teco	/ˈteko/
telamone	/telamˈone/
tela	/ˈtela/
tele	/ˈtele/
tema	/ˈtema/
temendo	/temˈɛndo/
temere	/temˈere/
teme	/ˈteme/
temeva	/temˈeva/
temo	/ˈtemo/
temperanza	/temperˈantsa/
temperata	/temperˈata/
temperato	/temperˈato/
tempesta	/tempˈɛsta/
tempeste	/tempˈɛste/
tempestoso	/tempestˈoso/
tempie	/ˈtɛmpje/
tempio	/ˈtɛmpjo/
tempi	/ˈtɛmpi/
temporale	/temporˈale/
temporali	/temporˈali/
tempo	/ˈtɛmpo/
temuto	/temˈuto/
tenace	/tenˈatʃe/
tende	/ˈtɛnde/
tenebre	/ˈtɛnebre/
tenendo	/tenˈɛndo/
teneramente	/teneramˈente/
tenera	/ˈtɛnera/
tenere	/tenˈere/
tenerezza	/tenerˈetstsa/
tenerezze	/tenerˈetstse/
tenero	/ˈtɛnero/
tenesse	/tenˈesse/
tenete	/tenˈete/
tenevano	/tenˈevano/
teneva	/tenˈeva/
tenga	/ˈtɛŋɡa/
tengono	/ˈtɛŋɡono/
tengo	/ˈtɛŋɡo/
tennero	/ˈtennero/
tenne	/ˈtenne/
tenni	/ˈtenni/
tentare	/tentˈare/
tentato	/tentˈato/
tentò	/tentˈɔ/
tenuta	/tenˈuta/
tenute	/tenˈute/
tenuti	/tenˈuti/
tenuto	/tenˈuto/
teodoro	/teodˈɔro/
teologia	/teolodʒˈia/
teologica	/teolˈɔdʒika/
teologico	/teolˈɔdʒiko/
teorica	/teˈɔrika/
terminare	/terminˈare/
termina	/ˈtɛrmina/
termini	/ˈtɛrmini/
terranova	/terranˈɔva/
terra	/ˈtɛrra/
terrei	/terrˈɛi/
terrena	/terrˈena/
terrene	/terrˈene/
terreni	/terrˈeni/
terreno	/terrˈeno/
terre	/ˈtɛrre/
terribile	/terrˈibile/
terribili	/terrˈibili/
terrore	/terrˈore/
terrò	/terrˈɔ/
terza	/ˈtɛrtsa/
terze	/ˈtɛrtse/
terzodecimo	/tertsodˈɛtʃimo/
terzo	/ˈtɛrtso/
tese	/ˈtese/
tesi	/ˈtɛzi/
tesori	/tezˈɔri/
tesoro	/tezˈɔro/
tessa	/ˈtɛssa/
tessere	/ˈtɛssere/
testa	/ˈtɛsta/
testé	/testˈe/
testimoniano	/testimˈɔnjano/
testimonianza	/testimonjˈantsa/
testimonia	/testimˈɔnja/
testimonio	/testimˈɔnjo/
testimoni	/testimˈɔni/
testo	/ˈtɛsto/
te	/ˈte/
tetti	/ˈtetti/
tetto	/ˈtetto/
teucro	/ˈtɛukro/
tiene	/tjˈɛne/
tieni	/tjˈɛni/
timida	/ˈtimida/
timidi	/ˈtimidi/
timido	/ˈtimido/
timoni	/timˈoni/
timore	/timˈore/
timori	/timˈori/
tinta	/ˈtinta/
tirannia	/tirannˈia/
tiranno	/tirˈanno/
tirare	/tirˈare/
tirata	/tirˈata/
tirate	/tirˈate/
tira	/ˈtira/
tirati	/tirˈati/
tirato	/tirˈato/
tiro	/ˈtiro/
tirò	/tirˈɔ/
titani	/titˈani/
titano	/titˈano/
ti	/ˈti/
titoli	/ˈtitoli/
titolo	/ˈtitolo/
tito	/ˈtito/
tizzone	/titstsˈone/
toccando	/tokkˈando/
toccare	/tokkˈare/
toccasse	/tokkˈasse/
toccata	/tokkˈata/
tocca	/ˈtokka/
toccato	/tokkˈato/
toccava	/tokkˈava/
tocchi	/ˈtokki/
tocco	/ˈtokko/
toccò	/tokkˈɔ/
togliendo	/toʎʎˈɛndo/
togliesse	/toʎʎˈesse/
toglie	/ˈtɔʎʎe/
togli	/ˈtɔʎʎi/
tolga	/ˈtɔlɡa/
tolse	/ˈtɔlse/
tolta	/ˈtɔlta/
tolte	/ˈtɔlte/
tolti	/ˈtɔlti/
tolto	/ˈtɔlto/
tomba	/ˈtomba/
tommaso	/tommˈazo/
tondo	/ˈtondo/
tono	/ˈtɔno/
torello	/torˈɛllo/
tormenta	/tormˈenta/
tormentato	/tormentˈato/
tormenti	/tormˈenti/
tormento	/tormˈento/
tornando	/tornˈando/
tornano	/ˈtornano/
tornare	/tornˈare/
tornarono	/tornˈarono/
tornasse	/tornˈasse/
tornata	/tornˈata/
tornati	/tornˈati/
torna	/ˈtorna/
tornato	/tornˈato/
tornava	/tornˈava/
tornerò	/tornerˈɔ/
torni	/ˈtorni/
torno	/ˈtorno/
tornò	/tornˈɔ/
torre	/ˈtɔrre/
torri	/ˈtorri/
torti	/ˈtɔrti/
tor	/ˈtɔr/
torto	/ˈtɔrto/
toscanamente	/toskanamˈente/
toscana	/toskˈana/
toscane	/toskˈane/
toscani	/toskˈani/
tosto	/ˈtɔsto/
tradimento	/tradimˈento/
traditore	/traditˈore/
tradito	/tradˈito/
tradizione	/traditstsjˈone/
tradotta	/tradˈotta/
traendo	/traˈɛndo/
traesse	/traˈesse/
trae	/trˈae/
tragedia	/tradʒˈɛdia/
tragico	/trˈadʒiko/
tramontana	/tramontˈana/
tranquilla	/traŋkwˈilla/
tranquillità	/traŋkwillitˈa/
tranquillo	/traŋkwˈillo/
trapani	/trˈapani/
trapassare	/trapassˈare/
trapassata	/trapassˈata/
trapassato	/trapassˈato/
trapassi	/trapˈassi/
trapassò	/trapassˈɔ/
trarre	/trˈarre/
trascorrere	/traskˈorrere/
trasformato	/trasformˈato/
trassero	/trˈassero/
trasse	/trˈasse/
tra	/tra/
trattando	/trattˈando/
trattare	/trattˈare/
trattato	/trattˈato/
tratta	/trˈatta/
trattava	/trattˈava/
tratterà	/tratterˈa/
tratte	/trˈatte/
tratti	/trˈatti/
tratto	/trˈatto/
travagliati	/travaʎʎˈati/
travagliato	/travaʎʎˈato/
travagli	/travˈaʎʎi/
trecento	/tretʃˈɛnto/
tredici	/trˈeditʃi/
tremando	/tremˈando/
tremante	/tremˈante/
tremanti	/tremˈanti/
tremare	/tremˈare/
tremava	/tremˈava/
trenta	/trˈenta/
trentesimo	/trentˈɛzimo/
tre	/trˈɛ/
tribunali	/tribunˈali/
trinità	/trinitˈa/
trionfo	/triˈonffo/
triplice	/trˈiplitʃe/
trista	/trˈista/
triste	/trˈiste/
tristezza	/tristˈetstsa/
tristi	/trˈisti/
tristizia	/tristˈitstsja/
tristo	/trˈisto/
troiana	/trojˈana/
troiani	/trojˈani/
troiano	/trojˈano/
troia	/trˈɔja/
troncato	/troŋkˈato/
tronco	/trˈoŋko/
troppa	/trˈɔppa/
troppi	/trˈɔppi/
troppo	/trˈɔppo/
trovata	/trovˈata/
trovate	/trovˈate/
trovati	/trovˈati/
trovato	/trovˈato/
tua	/ˈtua/
tue	/ˈtue/
tullio	/ˈtulljo/
tumulto	/tumˈulto/
tunisi	/ˈtunizi/
tuoni	/twˈɔni/
tuo	/ˈtuo/
turbamento	/turbamˈento/
turbare	/turbˈare/
turbata	/turbˈata/
turbati	/turbˈati/
turbato	/turbˈato/
turba	/ˈturba/
turbò	/turbˈɔ/
turno	/ˈturno/
tutta	/ˈtutta/
tuttavia	/tuttavˈia/
tutte	/ˈtutte/
tutti	/ˈtutti/
tutto	/ˈtutto/
tu	/tu/
uccelli	/utʃtʃˈɛlli/
uccello	/utʃtʃˈɛllo/
uccidere	/utʃtʃˈidere/
uccisa	/utʃtʃˈiza/
uccise	/utʃtʃˈize/
uccisi	/utʃtʃˈizi/
ucciso	/utʃtʃˈizo/
udendo	/udˈɛndo/
udii	/udˈii/
udine	/ˈudine/
udirete	/udirˈete/
udire	/udˈire/
udita	/udˈita/
udite	/udˈite/
uditi	/udˈiti/
udito	/udˈito/
udì	/udˈi/
udiva	/udˈiva/
ufficio	/uffˈitʃo/
uffici	/uffˈitʃi/
ugualmente	/uɡwalmˈente/
ulisse	/ulˈisse/
ulteriori	/ulterjˈori/
ulteriormente	/ulterjormˈente/
ultimamente	/ultimamˈente/
ultima	/ˈultima/
ultime	/ˈultime/
ultimi	/ˈultimi/
ultimo	/ˈultimo/
umana	/umˈana/
umane	/umˈane/
umanità	/umanitˈa/
umani	/umˈani/
umano	/umˈano/
umile	/ˈumile/
umili	/umˈili/
umilmente	/umilmˈente/
umiltà	/umiltˈa/
una	/ˈuna/
undecimo	/undˈɛtʃimo/
unico	/ˈuniko/
unità	/unitˈa/
uni	/ˈuni/
universale	/universˈale/
universalmente	/universalmˈente/
uno	/ˈuno/
un	/ˈun/
uomo	/ˈwɔmo/
uopo	/ˈwɔpo/
usando	/uzˈando/
usano	/ˈuzano/
usanza	/uzˈantsa/
usare	/uzˈare/
usarono	/uzˈarono/
usasse	/uzˈasse/
usata	/uzˈata/
usate	/uzˈate/
usati	/uzˈati/
usato	/uzˈato/
usa	/ˈuza/
usavano	/uzˈavano/
usava	/uzˈava/
uscendo	/uʃʃˈɛndo/
uscio	/ˈuʃʃo/
uscire	/uʃʃˈire/
uscirono	/uʃʃˈirono/
uscisse	/uʃʃˈisse/
uscita	/uʃʃˈita/
usciti	/uʃʃˈiti/
uscito	/uʃʃˈito/
uscì	/uʃʃˈi/
usciva	/uʃʃˈiva/
usiamo	/uzjˈamo/
usi	/ˈuzi/
uso	/ˈuzo/
usò	/uzˈɔ/
utile	/ˈutile/
utilità	/utilitˈa/
utili	/ˈutili/
ut	/ˈut/
vacca	/ˈvakka/
vadano	/ˈvadano/
vada	/ˈvada/
vagamente	/vaɡamˈente/
vaga	/ˈvaɡa/
vaghe	/ˈvaɡe/
vaghezza	/vaɡˈetstsa/
vaghi	/ˈvaɡi/
vaglia	/ˈvaʎʎa/
vagliono	/ˈvaʎʎono/
vago	/ˈvaɡo/
vai	/ˈvai/
valente	/valˈɛnte/
valenti	/valˈɛnti/
valere	/valˈere/
valerio	/valˈɛrjo/
valesse	/valˈesse/
vale	/ˈvale/
valeva	/valˈeva/
valle	/ˈvalle/
valli	/ˈvalli/
valore	/valˈore/
valorosamente	/valorosamˈente/
valorosa	/valorˈosa/
valorose	/valorˈose/
valorosi	/valorˈosi/
valoroso	/valorˈoso/
valse	/ˈvalse/
val	/ˈval/
vana	/ˈvana/
vane	/ˈvane/
vanità	/vanitˈa/
vani	/ˈvani/
vanno	/ˈvanno/
vano	/ˈvano/
vantaggio	/vantˈadʒdʒo/
vanto	/ˈvanto/
van	/ˈvan/
vapori	/vapˈori/
variazione	/varjatstsjˈone/
varietà	/varjetˈa/
varie	/ˈvarje/
varii	/ˈvarji/
vari	/ˈvari/
vaso	/ˈvazo/
và	/ˈva/
vecchiaia	/vekkjˈaja/
vecchia	/ˈvɛkkja/
vecchie	/ˈvɛkkje/
vecchiezza	/vekkjˈetstsa/
vecchio	/ˈvɛkkjo/
vecchi	/ˈvɛkki/
vece	/ˈvetʃe/
veda	/ˈveda/
vedendo	/vedˈɛndo/
vedere	/vedˈere/
vedessero	/vedˈessero/
vedesse	/vedˈesse/
vedessi	/vedˈessi/
vedeste	/vedˈeste/
vedesti	/vedˈesti/
vedete	/vedˈete/
vedevano	/vedˈevano/
vedeva	/vedˈeva/
vede	/ˈvede/
vedi	/ˈvedi/
vedova	/ˈvedova/
vedove	/ˈvedove/
vedrai	/vedrˈai/
vedranno	/vedrˈanno/
vedrà	/vedrˈa/
vedremo	/vedrˈemo/
vedrete	/vedrˈete/
veduta	/vedˈuta/
vedute	/vedˈute/
veduti	/vedˈuti/
veduto	/vedˈuto/
vegga	/ˈveɡɡa/
veggendo	/vedʒdʒˈɛndo/
veggiamo	/vedʒdʒˈamo/
veggia	/ˈvedʒdʒa/
veggio	/ˈvedʒdʒo/
veggono	/ˈveɡɡono/
veggo	/ˈveɡɡo/
vegnente	/veɲɲˈɛnte/
vela	/ˈvela/
velenosa	/velenˈosa/
veleno	/velˈeno/
vele	/ˈvele/
veli	/ˈveli/
vello	/ˈvɛllo/
velocemente	/velotʃemˈente/
veloce	/velˈotʃe/
velocissimo	/velotʃˈissimo/
velocità	/velotʃitˈa/
velo	/ˈvelo/
vena	/ˈvena/
vendere	/ˈvendere/
vendetta	/vendˈetta/
vendicare	/vendikˈare/
venduta	/vendˈuta/
venduto	/vendˈuto/
venendo	/venˈɛndo/
venerabile	/venerˈabile/
venerdì	/venerdˈi/
venere	/ˈvɛnere/
vene	/ˈvɛne/
vengano	/ˈvɛŋɡano/
venga	/ˈvɛŋɡa/
vengono	/ˈvɛŋɡono/
vengo	/ˈvɛŋɡo/
venia	/venˈia/
venire	/venˈire/
venissero	/venˈissero/
venisse	/venˈisse/
venissi	/venˈissi/
venisti	/venˈisti/
venite	/venˈite/
venivano	/venˈivano/
veniva	/venˈiva/
vennero	/ˈvennero/
venne	/ˈvɛnne/
venni	/ˈvɛnni/
ventesimo	/ventˈɛzimo/
venti	/ˈvɛnti/
vento	/ˈvɛnto/
ventre	/ˈvɛntre/
ventura	/ventˈura/
venture	/ventˈure/
venuta	/venˈuta/
venute	/venˈute/
venuti	/venˈuti/
venuto	/venˈuto/
veramente	/veramˈente/
vera	/ˈvera/
verbi	/ˈvɛrbi/
verbo	/ˈvɛrbo/
verde	/ˈverde/
verdi	/ˈverdi/
vere	/ˈvere/
verga	/ˈvɛrɡa/
verghe	/ˈverɡe/
vergine	/ˈverdʒine/
verginità	/verdʒinitˈa/
vergini	/ˈverdʒini/
vergognano	/verɡˈoɲɲano/
vergognare	/verɡoɲɲˈare/
vergogna	/verɡˈoɲɲa/
vergognosamente	/verɡoɲɲosamˈente/
vergognosa	/verɡoɲɲˈosa/
vergognose	/verɡoɲɲˈose/
vergognoso	/verɡoɲɲˈoso/
vergognò	/verɡoɲɲˈɔ/
verissima	/verˈissima/
verità	/veritˈa/
veri	/ˈveri/
vermiglia	/vermˈiʎʎa/
vermiglie	/vermˈiʎʎe/
vermiglio	/vermˈiʎʎo/
vernaccia	/vernˈatʃtʃa/
verno	/ˈvɛrno/
verona	/verˈona/
vero	/ˈvero/
verrai	/verrˈai/
verranno	/verrˈanno/
verrebbe	/verrˈɛbbe/
versi	/ˈvɛrsi/
verso	/ˈvɛrso/
vertù	/vertˈu/
veruna	/verˈuna/
veruno	/verˈuno/
ver	/ˈvɛr/
vescovo	/ˈveskovo/
vespro	/ˈvɛspro/
vesta	/ˈvɛsta/
veste	/ˈvɛste/
vestigi	/vestˈidʒi/
vestimenti	/vestimˈenti/
vestimento	/vestimˈento/
vestire	/vestˈire/
vestita	/vestˈita/
vestite	/vestˈite/
vestiti	/vestˈiti/
vestito	/vestˈito/
vesti	/ˈvɛsti/
vetro	/ˈvetro/
ve	/ˈve/
vezzi	/ˈvetstsi/
viaggio	/viˈadʒdʒo/
viaggi	/viˈadʒdʒi/
viandanti	/viandˈanti/
via	/ˈvia/
vicario	/vikˈarjo/
vicenda	/vitʃˈɛnda/
vicina	/vitʃˈina/
vicine	/vitʃˈine/
vicini	/vitʃˈini/
vicino	/vitʃˈino/
videro	/ˈvidero/
vide	/ˈvide/
vidi	/ˈvidi/
viene	/viˈɛne/
vieni	/viˈɛni/
vietato	/vjetˈato/
vieta	/vjˈɛta/
vige	/ˈvidʒe/
vigilante	/vidʒilˈante/
vigilanza	/vidʒilˈantsa/
vigile	/ˈvidʒile/
vigilia	/vidʒˈilja/
vigilie	/vidʒˈilje/
vigne	/ˈviɲɲe/
vigore	/viɡˈore/
vigorosamente	/viɡorosamˈente/
vile	/ˈvile/
vilissima	/vilˈissima/
vili	/ˈvili/
villaggi	/villˈadʒdʒi/
villana	/villˈana/
villania	/villanˈia/
villani	/villˈani/
villano	/villˈano/
villa	/ˈvilla/
vilmente	/vilmˈente/
viltà	/viltˈa/
vincendo	/vintʃˈɛndo/
vincere	/ˈvintʃere/
vince	/ˈvintʃe/
vincitore	/vintʃitˈore/
vincitori	/vintʃitˈori/
vini	/ˈvini/
vino	/ˈvino/
vinse	/ˈvinse/
vinta	/ˈvinta/
vinte	/ˈvinte/
vinti	/ˈvinti/
vinto	/ˈvinto/
violante	/violˈante/
violata	/violˈata/
violenta	/violˈɛnta/
violento	/violˈɛnto/
violenza	/violˈɛntsa/
virgilio	/virdʒˈiljo/
virginità	/virdʒinitˈa/
virgulti	/virɡˈulti/
virile	/virˈile/
virilmente	/virilmˈente/
virtuosamente	/virtuosamˈente/
virtuosa	/virtuˈosa/
virtuose	/virtuˈose/
virtuosi	/virtuˈosi/
virtuoso	/virtuˈoso/
virtù	/virtˈu/
viscere	/ˈviʃʃere/
visibile	/vizˈibile/
visione	/vizjˈone/
visioni	/vizjˈoni/
visitare	/vizitˈare/
visitato	/vizitˈato/
visita	/ˈvizita/
visi	/ˈvizi/
viso	/ˈvizo/
visse	/ˈvisse/
vista	/ˈvista/
visto	/ˈvisto/
vita	/ˈvita/
viti	/ˈviti/
vittoria	/vittˈɔrja/
vittorie	/vittˈɔrje/
vittoriosi	/vittorjˈosi/
vittorioso	/vittorjˈoso/
vituperevole	/vituperˈevole/
vituperosamente	/vituperosamˈente/
vivanda	/vivˈanda/
vivande	/vivˈande/
viva	/ˈviva/
vivendo	/vivˈɛndo/
vivente	/vivˈɛnte/
viventi	/vivˈɛnti/
viverà	/viverˈa/
vivere	/ˈvivere/
viveva	/vivˈeva/
vive	/ˈvive/
vi	/ˈvi/
viviamo	/vivjˈamo/
vivi	/ˈvivi/
vivono	/ˈvivono/
vivo	/ˈvivo/
vivuto	/vivˈuto/
vizio	/ˈvitstsjo/
vizi	/ˈvitstsi/
vocaboli	/vokˈaboli/
vocabolo	/vokˈabolo/
vocale	/vokˈale/
vocali	/vokˈali/
voce	/ˈvotʃe/
voci	/ˈvotʃi/
vogliamo	/voʎʎˈamo/
vogliano	/ˈvɔʎʎano/
vogliate	/voʎʎˈate/
voglia	/ˈvɔʎʎa/
voglie	/ˈvɔʎʎe/
vogliono	/ˈvɔʎʎono/
voglio	/ˈvɔʎʎo/
vogli	/ˈvɔʎʎi/
voi	/ˈvoi/
volando	/volˈando/
volanti	/volˈanti/
volare	/volˈare/
vola	/ˈvola/
volendo	/volˈɛndo/
volentieri	/volentjˈɛri/
volere	/volˈere/
voleri	/volˈeri/
volessero	/volˈessero/
volesse	/volˈesse/
volessimo	/volˈessimo/
volessi	/volˈessi/
voleste	/volˈeste/
volete	/volˈete/
volevano	/volˈevano/
voleva	/volˈeva/
volevi	/volˈevi/
volgare	/volɡˈare/
volgari	/volɡˈari/
volgarmente	/volɡarmˈente/
volgendo	/voldʒˈɛndo/
volgere	/ˈvɔldʒere/
volge	/ˈvɔldʒe/
volgo	/ˈvɔlɡo/
vollero	/ˈvɔllero/
volle	/ˈvɔlle/
volli	/ˈvɔlli/
volontariamente	/volontarjamˈente/
volontà	/volontˈa/
volonteroso	/volonterˈoso/
volontieri	/volontjˈɛri/
volo	/ˈvolo/
volò	/volˈɔ/
volsero	/ˈvɔlsero/
volse	/ˈvɔlse/
voltata	/voltˈata/
voltato	/voltˈato/
volta	/ˈvɔlta/
volte	/ˈvɔlte/
volti	/ˈvɔlti/
voltò	/voltˈɔ/
volto	/ˈvɔlto/
volume	/volˈume/
volumi	/volˈumi/
voluta	/volˈuta/
voluti	/volˈuti/
voluto	/volˈuto/
voluttà	/voluttˈa/
vorrai	/vorrˈai/
vorrà	/vorrˈa/
vorrebbe	/vorrˈɛbbe/
vorrei	/vorrˈɛi/
vorremo	/vorrˈemo/
vorrete	/vorrˈete/
vorrò	/vorrˈɔ/
vostra	/vostra/
vostri	/vostri/
voti	/ˈvɔti/
voto	/ˈvɔto/
vo	/ˈvo/
vulcano	/vulkˈano/
vuogli	/vwˈɔʎʎi/
vuoi	/vwˈɔi/
vuole	/vwˈɔle/
vuoto	/vwˈɔto/
www	/vuvuvˈu/
zefiro	/ˈdzɛfiro/
zeppa	/ˈtseppa/
zia	/ˈtsia/
zio	/ˈtsio/
zodiaco	/dzodˈiako/
